//MAP CONVERTED BY dmm2tgm.py THIS HEADER COMMENT PREVENTS RECONVERSION, DO NOT REMOVE
"ab" = (
/turf/simulated/wall/r_wall,
/area/ship/crashed_ship)
"ac" = (
/obj/machinery/atmospherics/omni/filter{
	tag_east = 2;
	tag_north = 4;
	tag_south = 1
	},
/turf/simulated/floor/tiled/techfloor/grid,
/area/ship/crashed_ship)
"ad" = (
/obj/decal/cleanable/dirt,
/turf/simulated/floor/tiled/techfloor,
/area/ship/crashed_ship)
"ay" = (
/turf/simulated/wall,
/area/ship/crashed_ship)
"bb" = (
/obj/machinery/airlock_sensor/airlock_exterior{
	frequency = 1380;
	id_tag = "crashedpodWest_sensor_external";
	pixel_y = 32
	},
/obj/machinery/access_button/airlock_exterior{
	frequency = 1380;
	master_tag = "crashedpodWest";
	pixel_y = 20;
	pixel_z = 1
	},
/turf/simulated/floor/reinforced{
	map_airless = 1
	},
/area/ship/crashed_ship)
"bk" = (
/obj/machinery/atmospherics/pipe/manifold/visible/fuel{
	dir = 4
	},
/turf/simulated/wall/r_wall,
/area/ship/crashed_ship)
"bl" = (
/obj/machinery/atmospherics/unary/vent_pump/high_volume/external_air{
	dir = 8;
	id_tag = "crashedpodEast_pump_out_internal";
	power_rating = 25000
	},
/obj/machinery/embedded_controller/radio/airlock/airlock_controller{
	cycle_to_external_air = 1;
	frequency = 1380;
	id_tag = "crashedpodEast";
	pixel_y = 26;
	tag_airpump = "crashedpodEast_pump";
	tag_chamber_sensor = "crashedpodEast_sensor_chamber";
	tag_exterior_door = "crashedpodEast_exterior_door";
	tag_exterior_sensor = "crashedpodEast_sensor_external";
	tag_interior_door = "crashedpodEast_interior_door"
	},
/obj/machinery/airlock_sensor{
	frequency = 1380;
	id_tag = "crashedpodEast_sensor_chamber";
	pixel_x = -22
	},
/turf/simulated/floor/reinforced,
/area/ship/crashed_ship)
"bm" = (
/obj/machinery/door/airlock/external{
	frequency = 1380;
	id_tag = "crashedpodEast_exterior_door";
	locked = 1
	},
/turf/simulated/floor/reinforced{
	map_airless = 1
	},
/area/ship/crashed_ship)
"bn" = (
/obj/machinery/airlock_sensor/airlock_exterior{
	frequency = 1380;
	id_tag = "crashedpodEast_sensor_external";
	pixel_y = 32
	},
/obj/machinery/access_button/airlock_exterior{
	frequency = 1380;
	master_tag = "crashedpodEast";
	pixel_y = 20;
	pixel_z = 1
	},
/turf/simulated/floor/reinforced{
	map_airless = 1
	},
/area/ship/crashed_ship)
"bo" = (
/obj/machinery/atmospherics/pipe/simple/visible/fuel{
	dir = 9
	},
/obj/machinery/atmospherics/unary/tank/air,
/obj/machinery/light/small{
	dir = 4
	},
/turf/simulated/floor/tiled/techfloor/grid,
/area/ship/crashed_ship)
"bp" = (
/obj/machinery/atmospherics/unary/vent_pump/high_volume/external_air{
	id_tag = "crashedpodEast_pump";
	power_rating = 25000
	},
/obj/item/device/radio/intercom/hailing{
	dir = 8;
	pixel_x = 24
	},
/turf/simulated/floor/reinforced,
/area/ship/crashed_ship)
"bq" = (
/obj/machinery/atmospherics/portables_connector{
	dir = 4
	},
/obj/machinery/portable_atmospherics/canister/air,
/turf/simulated/floor/tiled/techfloor/grid,
/area/ship/crashed_ship)
"bs" = (
/obj/machinery/atmospherics/pipe/simple/visible/blue,
/obj/machinery/door/airlock/external{
	frequency = 1380;
	id_tag = "crashedpodEast_interior_door"
	},
/turf/simulated/floor/reinforced,
/area/ship/crashed_ship)
"bt" = (
/obj/machinery/access_button/airlock_interior{
	frequency = 1380;
	master_tag = "crashedpodEast";
	pixel_x = 22;
	pixel_y = 22
	},
/obj/machinery/atmospherics/pipe/manifold/visible/blue{
	dir = 4
	},
/turf/simulated/floor/tiled/techfloor/grid,
/area/ship/crashed_ship)
"bu" = (
/obj/machinery/atmospherics/unary/vent_pump/high_volume/external_air{
	dir = 4;
	id_tag = "crashedpodWest_pump_out_external";
	power_rating = 25000
	},
/turf/simulated/floor/reinforced{
	map_airless = 1
	},
/area/ship/crashed_ship)
"bE" = (
/obj/machinery/door/airlock/external{
	frequency = 1380;
	id_tag = "crashedpodWest_exterior_door";
	locked = 1
	},
/turf/simulated/floor/reinforced{
	map_airless = 1
	},
/area/ship/crashed_ship)
"bF" = (
/obj/machinery/atmospherics/unary/vent_pump/high_volume/external_air{
	dir = 4;
	id_tag = "crashedpodWest_pump_out_internal";
	power_rating = 25000
	},
/obj/machinery/embedded_controller/radio/airlock/airlock_controller{
	cycle_to_external_air = 1;
	frequency = 1380;
	id_tag = "crashedpodWest";
	pixel_y = 26;
	tag_airpump = "crashedpodWest_pump";
	tag_chamber_sensor = "crashedpodWest_sensor_chamber";
	tag_exterior_door = "crashedpodWest_exterior_door";
	tag_exterior_sensor = "crashedpodWest_sensor_external";
	tag_interior_door = "crashedpodWest_interior_door"
	},
/turf/simulated/floor/reinforced,
/area/ship/crashed_ship)
"bG" = (
/obj/machinery/airlock_sensor{
	frequency = 1380;
	id_tag = "crashedpodWest_sensor_chamber";
	pixel_x = 22
	},
/obj/machinery/atmospherics/pipe/simple/visible/red{
	dir = 4
	},
/turf/simulated/floor/reinforced,
/area/ship/crashed_ship)
"bH" = (
/obj/machinery/atmospherics/pipe/simple/visible/red{
	dir = 10
	},
/turf/simulated/wall/r_wall,
/area/ship/crashed_ship)
"bI" = (
/obj/machinery/portable_atmospherics/canister/empty,
/obj/machinery/atmospherics/portables_connector,
/turf/simulated/floor/tiled/techfloor/grid,
/area/ship/crashed_ship)
"bJ" = (
/obj/structure/fuel_port,
/turf/simulated/wall/r_wall,
/area/ship/crashed_ship)
"bK" = (
/obj/machinery/atmospherics/pipe/simple/visible/fuel{
	dir = 5
	},
/obj/machinery/meter,
/turf/simulated/wall/r_wall,
/area/ship/crashed_ship)
"bL" = (
/obj/machinery/atmospherics/pipe/simple/visible/red{
	dir = 6
	},
/turf/simulated/wall/r_wall,
/area/ship/crashed_ship)
"bW" = (
/obj/landmark/clear,
/turf/template_noop,
/area/template_noop)
"bX" = (
/obj/machinery/atmospherics/pipe/simple/visible/blue,
/obj/item/pen,
/obj/machinery/atmospherics/pipe/simple/visible/red{
	dir = 4
	},
/turf/simulated/floor/tiled/techfloor/grid,
/area/ship/crashed_ship)
"bY" = (
/obj/item/device/radio/intercom/hailing{
	dir = 4;
	pixel_x = -24
	},
/turf/simulated/floor/reinforced,
/area/ship/crashed_ship)
"ca" = (
/obj/machinery/atmospherics/pipe/manifold/visible/fuel{
	dir = 8
	},
/obj/machinery/meter,
/obj/machinery/light/small{
	dir = 8
	},
/turf/simulated/floor/tiled/techfloor/grid,
/area/ship/crashed_ship)
"cb" = (
/obj/machinery/atmospherics/binary/pump{
	dir = 4
	},
/turf/simulated/floor/tiled/techfloor/grid,
/area/ship/crashed_ship)
"cc" = (
/obj/machinery/atmospherics/pipe/simple/visible/fuel{
	dir = 4
	},
/obj/machinery/atmospherics/unary/tank/air,
/turf/simulated/floor/tiled/techfloor/grid,
/area/ship/crashed_ship)
"ej" = (
/turf/simulated/floor/reinforced{
	map_airless = 1
	},
/area/ship/crashed_ship)
"ek" = (
/obj/machinery/atmospherics/unary/vent_pump/high_volume/external_air{
	dir = 8;
	id_tag = "crashedpodEast_pump_out_external";
	power_rating = 25000
	},
/turf/simulated/floor/reinforced{
	map_airless = 1
	},
/area/ship/crashed_ship)
"el" = (
/obj/machinery/atmospherics/unary/vent_pump/high_volume/external_air{
	id_tag = "crashedpodWest_pump";
	power_rating = 25000
	},
/turf/simulated/floor/reinforced,
/area/ship/crashed_ship)
"em" = (
/obj/machinery/door/airlock/external{
	frequency = 1380;
	id_tag = "crashedpodWest_interior_door"
	},
/obj/machinery/atmospherics/pipe/simple/visible/blue,
/turf/simulated/floor/reinforced,
/area/ship/crashed_ship)
"en" = (
/obj/machinery/atmospherics/binary/pump{
	dir = 1
	},
/turf/simulated/floor/tiled/techfloor/grid,
/area/ship/crashed_ship)
"eo" = (
/obj/machinery/atmospherics/pipe/manifold/visible/blue,
/obj/machinery/meter,
/turf/simulated/floor/tiled/techfloor/grid,
/area/ship/crashed_ship)
"ep" = (
/obj/machinery/atmospherics/pipe/manifold/visible/blue{
	dir = 4
	},
/turf/simulated/floor/tiled/techfloor/grid,
/area/ship/crashed_ship)
"eq" = (
/obj/machinery/atmospherics/pipe/simple/visible/red,
/obj/wallframe_spawn/reinforced/hull,
/turf/simulated/floor/plating,
/area/ship/crashed_ship)
"eC" = (
/obj/machinery/computer/air_control{
	dir = 4;
	name = "Atmospheric Sensors";
	sensor_tag = "crashed_pod_out"
	},
/turf/simulated/floor/tiled/techfloor/grid,
/area/ship/crashed_ship)
"eD" = (
/obj/machinery/atmospherics/pipe/simple/visible/blue{
	dir = 5
	},
/obj/machinery/access_button/airlock_interior{
	frequency = 1380;
	master_tag = "crashedpodWest";
	pixel_x = -22;
	pixel_y = 22
	},
/turf/simulated/floor/tiled/techfloor/grid,
/area/ship/crashed_ship)
"eE" = (
/obj/machinery/atmospherics/unary/engine,
/turf/simulated/floor/reinforced{
	map_airless = 1
	},
/area/ship/crashed_ship)
"eG" = (
/obj/machinery/atmospherics/pipe/simple/visible/blue{
	dir = 4
	},
/obj/machinery/atmospherics/pipe/simple/visible/red,
/turf/simulated/floor/tiled/techfloor/grid,
/area/ship/crashed_ship)
"eH" = (
/obj/machinery/atmospherics/pipe/manifold/visible/blue{
	dir = 1
	},
/turf/simulated/floor/tiled/techfloor/grid,
/area/ship/crashed_ship)
"eI" = (
/obj/machinery/atmospherics/pipe/manifold/visible/blue,
/obj/decal/cleanable/dirt,
/turf/simulated/floor/tiled/techfloor/grid,
/area/ship/crashed_ship)
"eJ" = (
/obj/machinery/atmospherics/pipe/simple/visible/blue{
	dir = 4
	},
/obj/machinery/atmospherics/pipe/simple/visible/red,
/obj/item/wrench,
/turf/simulated/floor/tiled/techfloor/grid,
/area/ship/crashed_ship)
"eU" = (
/obj/wallframe_spawn/reinforced/hull,
/obj/machinery/atmospherics/pipe/simple/visible/red{
	dir = 4
	},
/turf/simulated/floor/plating,
/area/ship/crashed_ship)
"eW" = (
/obj/machinery/atmospherics/pipe/simple/visible/red{
	dir = 4
	},
/turf/simulated/floor/tiled/techfloor/grid,
/area/ship/crashed_ship)
"eY" = (
/obj/machinery/atmospherics/pipe/manifold4w/visible/red,
/obj/machinery/meter,
/turf/simulated/floor/tiled/techfloor/grid,
/area/ship/crashed_ship)
"eZ" = (
/obj/machinery/atmospherics/omni/filter{
	tag_north = 3;
	tag_south = 1;
	tag_west = 2
	},
/turf/simulated/floor/tiled/techfloor/grid,
/area/ship/crashed_ship)
"fb" = (
/obj/machinery/atmospherics/pipe/manifold/visible/red{
	dir = 1
	},
/turf/simulated/floor/tiled/techfloor/grid,
/area/ship/crashed_ship)
"ff" = (
/obj/machinery/atmospherics/pipe/simple/visible/blue,
/obj/decal/cleanable/dirt,
/turf/simulated/floor/tiled/techfloor/grid,
/area/ship/crashed_ship)
"fg" = (
/obj/machinery/atmospherics/pipe/manifold/visible/red{
	dir = 8
	},
/obj/structure/closet/hydrant{
	pixel_x = -27
	},
/obj/item/screwdriver,
/turf/simulated/floor/tiled/techfloor/grid,
/area/ship/crashed_ship)
"fh" = (
/obj/machinery/atmospherics/unary/vent_scrubber/on{
	dir = 8
	},
/obj/decal/cleanable/dirt,
/obj/item/solar_assembly,
/obj/item/solar_assembly,
/obj/item/solar_assembly,
/obj/item/solar_assembly,
/obj/item/solar_assembly,
/obj/item/solar_assembly,
/obj/item/solar_assembly,
/obj/item/solar_assembly,
/obj/item/solar_assembly,
/obj/item/solar_assembly,
/obj/item/solar_assembly,
/obj/item/solar_assembly,
/obj/item/solar_assembly,
/obj/floor_decal/industrial/hatch/orange,
/obj/structure/cable{
	d2 = 2;
	icon_state = "0-2";
	pixel_y = 1
	},
/obj/structure/railing/mapped{
	dir = 8;
	icon_state = "railing0-1"
	},
/obj/structure/railing/mapped{
	dir = 1;
	icon_state = "railing0-1"
	},
/turf/simulated/floor/tiled/techfloor/grid,
/area/ship/crashed_ship)
"fi" = (
/obj/item/device/multitool,
/obj/item/screwdriver,
/obj/item/cell/device/high,
/obj/item/cell/device/high,
/obj/item/cell/crap,
/obj/item/storage/box/lights,
/obj/item/device/scanner/gas,
/obj/item/reagent_containers/food/drinks/cans/speer,
/obj/item/reagent_containers/food/drinks/cans/speer,
/obj/item/reagent_containers/food/drinks/cans/speer,
/obj/item/storage/box/monkeycubes,
/obj/item/reagent_containers/food/drinks/bottle/vodka,
/obj/item/reagent_containers/food/drinks/bottle/specialwhiskey,
/obj/item/tracker_electronics,
/obj/item/pen/blue,
/obj/item/pen/green,
/obj/item/pen/red,
/obj/floor_decal/industrial/hatch/orange,
/obj/random/single/color/cable_coil,
/obj/random/single/color/cable_coil,
/obj/structure/closet/crate,
/obj/item/flame/lighter/random,
/obj/item/storage/box/lights/tubes,
/obj/random/powercell,
/obj/random/powercell,
/obj/random/powercell,
/obj/structure/railing/mapped{
	dir = 1;
	icon_state = "railing0-1"
	},
/obj/item/taperoll/engineering,
/turf/simulated/floor/tiled/techfloor/grid,
/area/ship/crashed_ship)
"fj" = (
/obj/floor_decal/industrial/hatch/orange,
/obj/machinery/atmospherics/pipe/simple/visible/red{
	dir = 5
	},
/obj/structure/railing/mapped{
	dir = 1;
	icon_state = "railing0-1"
	},
/obj/structure/railing/mapped{
	dir = 4;
	icon_state = "railing0-1"
	},
/obj/machinery/portable_atmospherics/canister/oxygen,
/turf/simulated/floor/tiled/techfloor/grid,
/area/ship/crashed_ship)
"fk" = (
/obj/machinery/atmospherics/pipe/manifold/visible/red,
/turf/simulated/floor/tiled/techfloor/grid,
/area/ship/crashed_ship)
"fl" = (
/obj/floor_decal/industrial/hatch/orange,
/obj/machinery/atmospherics/pipe/manifold/visible/red,
/obj/structure/railing/mapped{
	dir = 8;
	icon_state = "railing0-1"
	},
/obj/structure/railing/mapped{
	dir = 1;
	icon_state = "railing0-1"
	},
/obj/machinery/space_heater,
/turf/simulated/floor/tiled/techfloor/grid,
/area/ship/crashed_ship)
"fm" = (
/obj/structure/closet/crate/medical,
/obj/random/firstaid,
/obj/random/firstaid,
/obj/random/firstaid,
/obj/random/firstaid,
/obj/random/firstaid,
/obj/item/storage/firstaid/surgery,
/obj/item/storage/firstaid/stab,
/obj/item/storage/pill_bottle/antidexafen,
/obj/item/storage/pill_bottle/antidexafen,
/obj/item/storage/med_pouch/radiation,
/obj/item/storage/med_pouch/radiation,
/obj/item/storage/med_pouch/radiation,
/obj/item/storage/med_pouch/radiation,
/obj/item/storage/pill_bottle/assorted,
/obj/machinery/atmospherics/pipe/simple/visible/red{
	dir = 9
	},
/obj/floor_decal/industrial/hatch/orange,
/obj/structure/railing/mapped{
	dir = 1;
	icon_state = "railing0-1"
	},
/mob/living/simple_animal/passive/mouse/brown/Tom,
/turf/simulated/floor/tiled/techfloor/grid,
/area/ship/crashed_ship)
"fn" = (
/obj/machinery/atmospherics/unary/vent_pump/on{
	dir = 4
	},
/obj/floor_decal/industrial/hatch/orange,
/obj/structure/railing/mapped{
	dir = 1;
	icon_state = "railing0-1"
	},
/obj/structure/railing/mapped{
	dir = 4;
	icon_state = "railing0-1"
	},
/obj/machinery/fabricator/hacked,
/turf/simulated/floor/tiled/techfloor/grid,
/area/ship/crashed_ship)
"fx" = (
/obj/machinery/atmospherics/pipe/simple/visible/red,
/obj/machinery/alarm{
	dir = 4;
	locked = 0;
	pixel_x = -25;
	req_access = list()
	},
/turf/simulated/floor/tiled/techfloor/grid,
/area/ship/crashed_ship)
"fy" = (
/obj/decal/cleanable/dirt,
/obj/machinery/pipedispenser,
/obj/floor_decal/industrial/hatch/orange,
/obj/structure/cable,
/obj/machinery/power/terminal,
/obj/structure/railing/mapped{
	dir = 8;
	icon_state = "railing0-1"
	},
/turf/simulated/floor/tiled/techfloor/grid,
/area/ship/crashed_ship)
"fz" = (
/obj/decal/cleanable/dirt,
/obj/floor_decal/industrial/hatch/orange,
/obj/machinery/power/port_gen/pacman/super,
/turf/simulated/floor/tiled/techfloor/grid,
/area/ship/crashed_ship)
"fA" = (
/obj/decal/cleanable/dirt,
/obj/floor_decal/industrial/hatch/orange,
/obj/structure/closet/crate,
/obj/item/storage/briefcase/inflatable,
/obj/item/storage/briefcase/inflatable,
/obj/item/storage/briefcase/inflatable,
/obj/item/storage/briefcase/inflatable,
/obj/item/storage/briefcase/inflatable,
/obj/item/device/geiger,
/obj/item/device/geiger,
/obj/random/powercell,
/obj/random/powercell,
/obj/random/powercell,
/obj/structure/railing/mapped{
	dir = 4;
	icon_state = "railing0-1"
	},
/turf/simulated/floor/tiled/techfloor/grid,
/area/ship/crashed_ship)
"fC" = (
/obj/item/device/oxycandle,
/obj/item/device/oxycandle,
/obj/item/device/oxycandle,
/obj/item/device/oxycandle,
/obj/item/device/oxycandle,
/obj/item/device/oxycandle,
/obj/item/device/oxycandle,
/obj/item/device/oxycandle,
/obj/item/device/oxycandle,
/obj/item/device/oxycandle,
/obj/item/device/oxycandle,
/obj/item/device/oxycandle,
/obj/item/device/oxycandle,
/obj/item/device/oxycandle,
/obj/item/device/oxycandle,
/obj/item/device/oxycandle,
/obj/item/device/oxycandle,
/obj/item/device/oxycandle,
/obj/structure/closet/crate,
/obj/floor_decal/industrial/hatch/orange,
/obj/item/reagent_containers/glass/paint/random,
/obj/random/powercell,
/obj/random/powercell,
/obj/structure/railing/mapped{
	dir = 8;
	icon_state = "railing0-1"
	},
/obj/item/book/manual/engineering_construction,
/turf/simulated/floor/tiled/techfloor/grid,
/area/ship/crashed_ship)
"fD" = (
/obj/structure/closet/crate/warhammer/freezer/rations,
/obj/floor_decal/industrial/hatch/orange,
/obj/machinery/power/terminal,
/obj/structure/cable{
	d2 = 4;
	icon_state = "0-4"
	},
/turf/simulated/floor/tiled/techfloor/grid,
/area/ship/crashed_ship)
"fE" = (
/obj/structure/closet/crate,
/obj/random/handgun,
/obj/random/handgun,
/obj/random/handgun,
/obj/item/pickaxe,
/obj/item/pickaxe,
/obj/item/pickaxe,
/obj/item/stack/material/glass/fifty,
/obj/item/stack/material/glass/fifty,
/obj/item/stack/material/plasteel/fifty,
/obj/item/stack/material/plastic/fifty,
/obj/item/device/flashlight/lantern,
/obj/item/device/flashlight/lantern,
/obj/item/storage/box/glowsticks,
/obj/item/storage/box/glowsticks,
/obj/item/storage/box/glowsticks,
/obj/item/stack/material/steel/fifty,
/obj/item/stack/material/steel/fifty,
/obj/item/stack/material/steel/fifty,
/obj/random/toolbox,
/obj/random/toolbox,
/obj/random/toolbox,
/obj/random/toolbox,
/obj/floor_decal/industrial/hatch/orange,
/obj/structure/cable{
	d1 = 2;
	d2 = 8;
	icon_state = "2-8"
	},
/obj/structure/railing/mapped{
	dir = 4;
	icon_state = "railing0-1"
	},
/obj/item/stock_parts/circuitboard/solar_control,
/turf/simulated/floor/tiled/techfloor/grid,
/area/ship/crashed_ship)
"fP" = (
/obj/machinery/atmospherics/pipe/simple/visible/red,
/obj/structure/sign/warning/nosmoking_burned{
	dir = 1;
	pixel_x = -32
	},
/turf/simulated/floor/tiled/techfloor/grid,
/area/ship/crashed_ship)
"fQ" = (
/obj/machinery/power/apc{
	locked = 0;
	name = "south bump";
	pixel_y = -28;
	req_access = list()
	},
/obj/structure/cable{
	d2 = 4;
	icon_state = "0-4"
	},
/obj/machinery/portable_atmospherics/canister/carbon_dioxide,
/obj/floor_decal/industrial/hatch/orange,
/obj/structure/cable{
	d2 = 8;
	icon_state = "0-8"
	},
/turf/simulated/floor/tiled/techfloor/grid,
/area/ship/crashed_ship)
"fR" = (
/obj/structure/closet/crate,
/obj/floor_decal/industrial/hatch/orange,
/obj/structure/cable{
	d1 = 4;
	d2 = 8;
	icon_state = "4-8"
	},
/obj/structure/railing/mapped{
	dir = 4;
	icon_state = "railing0-1"
	},
/obj/item/stock_parts/micro_laser/ultra,
/obj/item/stock_parts/matter_bin/adv,
/obj/item/stock_parts/circuitboard/biogenerator,
/obj/item/stock_parts/matter_bin/super,
/obj/item/stack/material/uranium/ten,
/obj/item/stock_parts/circuitboard/oxyregenerator,
/obj/item/stock_parts/circuitboard/unary_atmos/heater,
/obj/item/stock_parts/circuitboard/unary_atmos/cooler,
/obj/item/device/scanner/gas,
/turf/simulated/floor/tiled/techfloor/grid,
/area/ship/crashed_ship)
"fS" = (
/obj/structure/cable{
	d1 = 4;
	d2 = 8;
	icon_state = "4-8"
	},
/turf/simulated/floor/tiled/techfloor/grid,
/area/ship/crashed_ship)
"fT" = (
/obj/structure/cable,
/obj/floor_decal/industrial/hatch/orange,
/obj/structure/reagent_dispensers/watertank,
/obj/machinery/light/spot,
/obj/structure/railing/mapped{
	dir = 4;
	icon_state = "railing0-1"
	},
/turf/simulated/floor/tiled/techfloor/grid,
/area/ship/crashed_ship)
"gd" = (
/obj/floor_decal/industrial/hatch/orange,
/obj/machinery/light/spot,
/obj/structure/cable{
	d2 = 4;
	icon_state = "0-4"
	},
/obj/machinery/power/smes/batteryrack,
/obj/structure/railing/mapped{
	dir = 8;
	icon_state = "railing0-1"
	},
/turf/simulated/floor/tiled/techfloor/grid,
/area/ship/crashed_ship)
"ge" = (
/obj/machinery/atmospherics/pipe/simple/visible/red,
/obj/machinery/door/airlock/civilian,
/obj/machinery/door/firedoor,
/turf/simulated/floor/tiled/techfloor,
/area/ship/crashed_ship)
"gg" = (
/obj/decal/cleanable/dirt,
/turf/simulated/floor/tiled/techfloor/grid,
/area/ship/crashed_ship)
"gh" = (
/obj/structure/cable{
	d1 = 4;
	d2 = 8;
	icon_state = "4-8"
	},
/obj/floor_decal/industrial/hatch/orange,
/obj/structure/railing/mapped{
	dir = 8;
	icon_state = "railing0-1"
	},
/obj/structure/reagent_dispensers/fueltank,
/turf/simulated/floor/tiled/techfloor/grid,
/area/ship/crashed_ship)
"gi" = (
/obj/machinery/power/smes/buildable{
	charge = 10000;
	inputting = 1;
	outputting = 1
	},
/obj/structure/cable{
	d2 = 8;
	icon_state = "0-8"
	},
/obj/floor_decal/industrial/hatch/orange,
/turf/simulated/floor/tiled/techfloor/grid,
/area/ship/crashed_ship)
"gv" = (
/obj/machinery/atmospherics/pipe/simple/visible/blue,
/turf/simulated/floor/tiled/techfloor/grid,
/area/ship/crashed_ship)
"gw" = (
/obj/structure/closet,
/obj/random/clothing,
/obj/random/clothing,
/obj/random/clothing,
/obj/random/clothing,
/obj/random/clothing,
/obj/random/clothing,
/obj/random/clothing,
/obj/random/clothing,
/obj/random/gloves,
/obj/random/hat,
/obj/random/hat,
/obj/random/hat,
/obj/item/clothing/under/color/orange,
/obj/item/clothing/under/color/orange,
/obj/item/clothing/under/color/blackjumpshorts,
/obj/item/clothing/under/color/black,
/obj/decal/cleanable/dirt,
/obj/floor_decal/industrial/hatch/orange,
/obj/structure/railing/mapped{
	dir = 8;
	icon_state = "railing0-1"
	},
/turf/simulated/floor/tiled/techfloor/grid,
/area/ship/crashed_ship)
"gx" = (
/obj/structure/closet,
/obj/random/clothing,
/obj/random/clothing,
/obj/random/clothing,
/obj/random/clothing,
/obj/random/clothing,
/obj/random/clothing,
/obj/random/clothing,
/obj/random/clothing,
/obj/random/gloves,
/obj/random/hat,
/obj/random/hat,
/obj/random/hat,
/obj/item/clothing/under/color/orange,
/obj/item/clothing/under/color/orange,
/obj/item/clothing/under/color/blackjumpshorts,
/obj/item/clothing/under/color/black,
/obj/decal/cleanable/dirt,
/obj/floor_decal/industrial/hatch/orange,
/obj/structure/railing/mapped{
	dir = 4;
	icon_state = "railing0-1"
	},
/turf/simulated/floor/tiled/techfloor/grid,
/area/ship/crashed_ship)
"gy" = (
/obj/machinery/atmospherics/pipe/simple/visible/blue,
/obj/machinery/door/airlock/civilian,
/obj/machinery/door/firedoor,
/turf/simulated/floor/tiled/techfloor,
/area/ship/crashed_ship)
"gz" = (
/obj/structure/bed/chair/shuttle/black{
	dir = 4
	},
/obj/submap_landmark/spawnpoint/pod,
/obj/item/device/radio/intercom/hailing{
	dir = 4;
	pixel_x = -24
	},
/turf/simulated/floor/tiled/dark/monotile,
/area/ship/crashed_ship)
"gC" = (
/obj/machinery/atmospherics/pipe/simple/visible/red,
/obj/structure/closet/hydrant{
	pixel_x = -27
	},
/turf/simulated/floor/tiled/techfloor,
/area/ship/crashed_ship)
"gD" = (
/obj/machinery/atmospherics/pipe/simple/visible/red,
/obj/decal/cleanable/filth,
/obj/item/device/binoculars,
/obj/machinery/alarm{
	dir = 4;
	locked = 0;
	pixel_x = -25;
	req_access = list()
	},
/turf/simulated/floor/tiled/techfloor,
/area/ship/crashed_ship)
"gE" = (
/obj/machinery/sleeper{
	dir = 8
	},
/obj/floor_decal/industrial/outline/blue,
/turf/simulated/floor/tiled/dark/monotile,
/area/ship/crashed_ship)
"gF" = (
/turf/simulated/floor/tiled/techfloor/grid,
/area/ship/crashed_ship)
"gG" = (
/obj/structure/closet,
/obj/random/clothing,
/obj/random/clothing,
/obj/random/clothing,
/obj/random/clothing,
/obj/random/clothing,
/obj/random/clothing,
/obj/random/clothing,
/obj/random/clothing,
/obj/random/gloves,
/obj/random/hat,
/obj/random/hat,
/obj/random/hat,
/obj/item/clothing/under/color/orange,
/obj/item/clothing/under/color/orange,
/obj/item/clothing/under/color/blackjumpshorts,
/obj/item/clothing/under/color/black,
/obj/floor_decal/industrial/hatch/orange,
/obj/structure/railing/mapped{
	dir = 8;
	icon_state = "railing0-1"
	},
/turf/simulated/floor/tiled/techfloor/grid,
/area/ship/crashed_ship)
"gH" = (
/obj/machinery/door/airlock/civilian,
/obj/machinery/door/firedoor,
/turf/simulated/floor/tiled/techfloor,
/area/ship/crashed_ship)
"gI" = (
/obj/machinery/atmospherics/pipe/simple/visible/blue,
/obj/decal/cleanable/dirt,
/turf/simulated/floor/tiled/techfloor,
/area/ship/crashed_ship)
"gJ" = (
/obj/machinery/atmospherics/pipe/simple/visible/blue,
/obj/decal/cleanable/dirt,
/obj/item/toy/figure/engineer,
/turf/simulated/floor/tiled/techfloor,
/area/ship/crashed_ship)
"gK" = (
/obj/structure/bed/chair/shuttle/black{
	dir = 4
	},
/obj/decal/cleanable/vomit,
/obj/submap_landmark/spawnpoint/podnoble,
/turf/simulated/floor/tiled/dark/monotile,
/area/ship/crashed_ship)
"gT" = (
/obj/item/trash/liquidfood,
/obj/decal/cleanable/dirt,
/turf/simulated/floor/tiled/techfloor,
/area/ship/crashed_ship)
"gU" = (
/obj/machinery/atmospherics/pipe/simple/visible/red{
	dir = 5
	},
/obj/decal/cleanable/dirt,
/obj/machinery/light/spot{
	dir = 8
	},
/turf/simulated/floor/tiled/techfloor,
/area/ship/crashed_ship)
"gV" = (
/obj/machinery/atmospherics/unary/vent_scrubber/on{
	dir = 8
	},
/turf/simulated/floor/tiled/techfloor,
/area/ship/crashed_ship)
"gW" = (
/obj/decal/cleanable/dirt,
/obj/item/reagent_containers/food/drinks/cans/speer,
/turf/simulated/floor/tiled/techfloor,
/area/ship/crashed_ship)
"gX" = (
/obj/item/storage/backpack/dufflebag/eng,
/turf/simulated/floor/tiled/techfloor,
/area/ship/crashed_ship)
"gZ" = (
/obj/machinery/atmospherics/unary/vent_pump/on{
	dir = 4
	},
/turf/simulated/floor/tiled/techfloor,
/area/ship/crashed_ship)
"hh" = (
/obj/decal/cleanable/dirt,
/obj/structure/closet/emcloset,
/obj/item/crowbar,
/obj/item/crowbar,
/obj/floor_decal/industrial/outline/blue,
/obj/item/clothing/suit/space/emergency,
/obj/item/tank/oxygen_emergency_double,
/obj/item/clothing/head/helmet/space/emergency,
/obj/item/device/suit_cooling_unit,
/turf/simulated/floor/tiled/dark,
/area/ship/crashed_ship)
"hi" = (
/obj/structure/closet/emcloset,
/obj/floor_decal/industrial/outline/blue,
/obj/item/clothing/suit/space/emergency,
/obj/item/tank/oxygen_emergency_double,
/obj/item/clothing/head/helmet/space/emergency,
/obj/item/storage/briefcase/inflatable,
/obj/item/device/suit_cooling_unit,
/turf/simulated/floor/tiled/dark,
/area/ship/crashed_ship)
"hj" = (
/obj/machinery/atmospherics/pipe/simple/visible/blue{
	dir = 9
	},
/obj/machinery/light/spot{
	dir = 4
	},
/turf/simulated/floor/tiled/techfloor,
/area/ship/crashed_ship)
"hk" = (
/obj/structure/table/steel_reinforced,
/obj/machinery/recharger,
/obj/item/reagent_containers/food/drinks/glass2/coffeecup/metal,
/turf/simulated/floor/tiled/dark,
/area/ship/crashed_ship)
"hm" = (
/obj/structure/sign/kiddieplaque{
	desc = "A plaque with information regarding this particular lifepod. It reads: 'Armalev Industries Skyfin-E, Exoplanetary Suvival Pod' there's a registry number, and an assigned mothership, but they've both been scratched to illegiblity.";
	name = "\improper Lifepod Plaque";
	pixel_y = 30
	},
/turf/simulated/floor/tiled/techfloor,
/area/ship/crashed_ship)
"lG" = (
/obj/wallframe_spawn/reinforced/hull,
/turf/simulated/floor/plating,
/area/ship/crashed_ship)
"pO" = (
/obj/decal/cleanable/dirt,
/obj/machinery/radio_beacon,
/turf/simulated/floor/tiled/dark,
/area/ship/crashed_ship)
"vG" = (
/obj/decal/cleanable/dirt,
/obj/floor_decal/industrial/outline/blue,
/obj/machinery/portable_atmospherics/powered/pump/filled,
/turf/simulated/floor/tiled/dark,
/area/ship/crashed_ship)
"ED" = (
/obj/submap_landmark/joinable_submap/crashed_pod,
/turf/simulated/floor/tiled/dark/monotile,
/area/ship/crashed_ship)
"Gp" = (
/obj/decal/cleanable/dirt,
/obj/floor_decal/industrial/outline/blue,
/obj/machinery/portable_atmospherics/powered/scrubber,
/turf/simulated/floor/tiled/dark,
/area/ship/crashed_ship)
"Hp" = (
/obj/machinery/sleeper{
	dir = 8
	},
/obj/floor_decal/industrial/outline/blue,
/obj/item/device/radio/intercom/hailing{
	dir = 8;
	pixel_x = 24
	},
/turf/simulated/floor/tiled/dark/monotile,
/area/ship/crashed_ship)
"Hx" = (
/obj/machinery/air_sensor{
	id_tag = "crashed_pod_out"
	},
/turf/simulated/floor/reinforced{
	map_airless = 1
	},
/area/ship/crashed_ship)
"RN" = (
/obj/structure/table/steel_reinforced,
/obj/item/device/radio/hailing,
/obj/item/device/radio/hailing,
/obj/item/device/radio/hailing,
/obj/item/device/radio/hailing,
/obj/item/device/radio/hailing,
/obj/random/plushie,
/obj/item/paper_bin,
/turf/simulated/floor/tiled/dark,
/area/ship/crashed_ship)
"Sh" = (
/obj/machinery/atmospherics/pipe/manifold/visible/blue{
	dir = 1
	},
/obj/overmap/visitable/ship/landable/crashed_ship,
/turf/simulated/floor/tiled/techfloor/grid,
/area/ship/crashed_ship)
"ZI" = (
/obj/floor_decal/industrial/outline/blue,
/obj/machinery/portable_atmospherics/powered/scrubber,
/turf/simulated/floor/tiled/dark/monotile,
/area/ship/crashed_ship)

(1,1,1) = {"
bW
bW
bW
bW
bW
bW
bW
bW
bW
bW
bW
bW
bW
bW
bW
"}
(2,1,1) = {"
ab
bb
ej
ej
Hx
bu
ej
ej
ej
ej
ej
ej
ej
ej
ej
"}
(3,1,1) = {"
ab
bE
ab
ab
lG
eU
ab
ab
ab
ab
ab
ab
ab
ab
ab
"}
(4,1,1) = {"
ab
bF
bY
ab
eC
fb
fg
fx
fP
ge
gC
gD
gU
hk
ab
"}
(5,1,1) = {"
ab
bG
el
em
eD
eW
fh
fy
gd
ay
Hp
gE
gV
RN
ab
"}
(6,1,1) = {"
ab
bH
eq
eq
eG
fk
fi
fz
fQ
ay
ay
ay
gW
hh
ab
"}
(7,1,1) = {"
ab
bI
ca
en
eG
eY
fj
fA
fR
gx
gx
ay
gX
hi
lG
"}
(8,1,1) = {"
ab
bJ
cb
bq
Sh
eZ
fk
gg
fS
gg
gF
gH
ad
ED
lG
"}
(9,1,1) = {"
eE
bK
cc
eo
eH
ac
fl
fC
gh
gw
gG
ay
hm
pO
lG
"}
(10,1,1) = {"
eE
bk
bo
ep
eI
fb
fm
fD
gi
ay
ay
ay
gT
vG
ab
"}
(11,1,1) = {"
ab
bL
eq
eq
eJ
fk
fn
fE
fT
ay
gz
gK
gZ
Gp
ab
"}
(12,1,1) = {"
ab
bl
bp
bs
bt
bX
ep
ff
gv
gy
gI
gJ
hj
ZI
ab
"}
(13,1,1) = {"
ab
bm
ab
ab
lG
eU
ab
ab
ab
ab
ab
ab
ab
ab
ab
"}
(14,1,1) = {"
ab
bn
ej
ej
ej
ek
ej
ej
ej
ej
ej
ej
ej
ej
ej
"}
(15,1,1) = {"
bW
bW
bW
bW
bW
bW
bW
bW
bW
bW
bW
bW
bW
bW
bW
"}
