"aa" = (/turf/template_noop,/area/map_template/crashed_shuttle/crash)
"ab" = (/turf/template_noop,/area/template_noop)
"ac" = (/obj/decal/cleanable/generic,/turf/simulated/floor/warhammer/lfloorscorched1,/area/map_template/crashed_shuttle/graysontug)
"ad" = (/obj/structure/girder,/turf/simulated/floor/warhammer/lfloorscorched1,/area/map_template/crashed_shuttle/graysontug)
"ae" = (/obj/item/material/shard,/obj/item/stack/material/rods,/obj/machinery/door/firedoor,/turf/simulated/floor/plating,/area/map_template/crashed_shuttle/graysontug)
"af" = (/obj/item/stack/material/rods,/obj/machinery/door/firedoor,/turf/simulated/floor/warhammer/lfloorscorched1,/area/map_template/crashed_shuttle/graysontug)
"ag" = (/obj/structure/girder,/turf/simulated/floor/plating,/area/map_template/crashed_shuttle/graysontug)
"ah" = (/obj/item/handcuffs,/turf/template_noop,/area/map_template/crashed_shuttle/crash)
"ai" = (/turf/simulated/floor/warhammer/lfloorscorched1,/area/map_template/crashed_shuttle/graysontug)
"aj" = (/obj/machinery/radio_beacon,/turf/simulated/floor/warhammer/splate,/area/map_template/crashed_shuttle/graysontug)
"ak" = (/obj/structure/table/steel,/obj/item/exploration_loot/odd_book,/turf/simulated/floor/warhammer/splate,/area/map_template/crashed_shuttle/graysontug)
"al" = (/obj/item/stack/material/rods,/obj/machinery/computer/shuttle_control/explore/graysontug{dir = 8},/turf/simulated/floor/warhammer/splate,/area/map_template/crashed_shuttle/graysontug)
"am" = (/obj/item/material/shard,/obj/structure/firedoor_assembly,/turf/simulated/floor/plating,/area/map_template/crashed_shuttle/graysontug)
"an" = (/obj/item/material/shard/shrapnel/titanium,/turf/template_noop,/area/map_template/crashed_shuttle/crash)
"ao" = (/obj/landmark/corpse/bloodpact,/turf/template_noop,/area/template_noop)
"ap" = (/obj/decal/cleanable/generic,/turf/template_noop,/area/map_template/crashed_shuttle/crash)
"aq" = (/obj/item/material/shard/shrapnel/titanium,/obj/machinery/atmospherics/unary/vent_pump/high_volume/external_air{id_tag = "graysontug_shuttle_pump"},/turf/simulated/floor/warhammer/lfloorscorched1,/area/map_template/crashed_shuttle/graysontug)
"ar" = (/obj/structure/girder/displaced,/obj/machinery/atmospherics/unary/vent_pump/high_volume/external_air{id_tag = "graysontug_shuttle_pump"},/turf/simulated/floor/plating,/area/map_template/crashed_shuttle/graysontug)
"as" = (/obj/paint/red,/turf/simulated/wall/titanium,/area/map_template/crashed_shuttle/graysontug)
"at" = (/obj/machinery/constructable_frame/computerframe{dir = 4},/obj/item/stock_parts/circuitboard/engine,/obj/item/material/shard,/obj/machinery/atmospherics/pipe/simple/hidden/scrubbers{dir = 6},/turf/simulated/floor/warhammer/splate,/area/map_template/crashed_shuttle/graysontug)
"au" = (/obj/structure/bed/chair/shuttle/blue{dir = 1; icon_state = "shuttle_chair_preview"},/obj/machinery/atmospherics/unary/vent_scrubber/on{dir = 8},/obj/overmap/visitable/ship/landable/graysontug,/obj/shuttle_landmark/graysontug/start,/obj/decal/cleanable/blood/oil,/turf/simulated/floor/warhammer/splate,/area/map_template/crashed_shuttle/graysontug)
"av" = (/obj/machinery/computer/ship/helm{dir = 8},/turf/simulated/floor/warhammer/splate,/area/map_template/crashed_shuttle/graysontug)
"aw" = (/obj/item/material/shard,/obj/item/stack/material/rods,/obj/machinery/door/firedoor,/obj/machinery/door/firedoor,/turf/simulated/floor/plating,/area/map_template/crashed_shuttle/graysontug)
"ax" = (/obj/structure/cable/yellow{d1 = 2; d2 = 4; icon_state = "2-4"},/obj/item/stack/material/rods,/obj/machinery/atmospherics/pipe/simple/hidden{dir = 5; icon_state = "intact"},/obj/machinery/airlock_sensor{frequency = 1380; id_tag = "graysontug_shuttle_sensor"; pixel_x = -24; pixel_y = -7},/obj/item/remains/robot,/turf/simulated/floor/plating,/area/map_template/crashed_shuttle/graysontug)
"ay" = (/obj/structure/cable/yellow{d1 = 4; d2 = 8; icon_state = "4-8"},/obj/machinery/atmospherics/pipe/manifold/hidden,/obj/random/loot/randomsupply/engineering,/turf/simulated/floor/warhammer/splate,/area/map_template/crashed_shuttle/graysontug)
"az" = (/obj/structure/cable/yellow{d1 = 4; d2 = 8; icon_state = "4-8"},/obj/machinery/door/airlock/external{id_tag = "graysontug_shuttle_inner"; frequency = 1380},/obj/machinery/atmospherics/pipe/simple/hidden{dir = 4},/turf/simulated/floor/plating,/area/map_template/crashed_shuttle/graysontug)
"aA" = (/obj/structure/cable/yellow{d1 = 4; d2 = 8; icon_state = "4-8"},/obj/machinery/atmospherics/pipe/simple/hidden{dir = 10; icon_state = "intact"},/obj/machinery/atmospherics/pipe/simple/hidden/scrubbers,/obj/machinery/access_button/airlock_exterior{frequency = 1380; master_tag = "graysontug_shuttle"; pixel_x = -25; pixel_y = 30},/obj/random/loot/randomsupply/engineering,/turf/simulated/floor/warhammer/splate,/area/map_template/crashed_shuttle/graysontug)
"aB" = (/obj/structure/cable/yellow{d1 = 2; d2 = 8; icon_state = "2-8"},/obj/item/material/shard/shrapnel/titanium,/obj/machinery/atmospherics/unary/vent_pump/on,/obj/decal/cleanable/blood/gibs/core,/turf/simulated/floor/warhammer/splate,/area/map_template/crashed_shuttle/graysontug)
"aC" = (/obj/machinery/constructable_frame/computerframe{dir = 8},/obj/item/stock_parts/circuitboard/sensors,/obj/item/material/shard,/turf/simulated/floor/warhammer/splate,/area/map_template/crashed_shuttle/graysontug)
"aD" = (/obj/decal/cleanable/vomit,/turf/template_noop,/area/map_template/crashed_shuttle/crash)
"aE" = (/obj/decal/cleanable/blood/gibs,/turf/template_noop,/area/map_template/crashed_shuttle/crash)
"aF" = (/obj/item/organ/internal/augment/armor,/turf/simulated/floor/plating,/area/map_template/crashed_shuttle/graysontug)
"aG" = (/obj/structure/cable/yellow{d1 = 1; d2 = 2; icon_state = "1-2"},/obj/decal/cleanable/generic,/obj/machinery/atmospherics/unary/vent_pump/high_volume/external_air{id_tag = "graysontug_shuttle_pump_out_internal"},/turf/simulated/floor/warhammer/splate,/area/map_template/crashed_shuttle/graysontug)
"aH" = (/obj/machinery/atmospherics/unary/vent_pump/high_volume/external_air{id_tag = "graysontug_shuttle_pump_out_internal"},/obj/structure/handrail{dir = 8; icon_state = "handrail"},/obj/machinery/embedded_controller/radio/airlock/docking_port{cycle_to_external_air = 1; dir = 8; frequency = 1380; id_tag = "graysontug_shuttle"; pixel_x = 22; pixel_y = 4; tag_exterior_door = "graysontug_shuttle_outer"; tag_interior_door = "graysontug_shuttle_inner"; tag_exterior_sensor = "graysontug_shuttle_exterior_sensor"; tag_chamber_sensor = "graysontug_shuttle_sensor"; tag_airpump = "graysontug_shuttle_pump"; tag_interior_sensor = "graysontug_shuttle_interior_sensor"},/turf/simulated/floor/warhammer/splate,/area/map_template/crashed_shuttle/graysontug)
"aI" = (/obj/machinery/atmospherics/pipe/simple/hidden,/obj/machinery/atmospherics/pipe/simple/hidden/scrubbers,/obj/structure/closet/hydrant{pixel_x = -32},/obj/item/robot_parts/robot_component/actuator,/turf/simulated/floor/warhammer/splate,/area/map_template/crashed_shuttle/graysontug)
"aJ" = (/obj/structure/cable/yellow{d1 = 2; d2 = 4; icon_state = "2-4"},/obj/structure/cable/yellow{d1 = 1; d2 = 2; icon_state = "1-2"},/obj/machinery/atmospherics/pipe/simple/hidden/supply,/turf/simulated/floor/warhammer/splate,/area/map_template/crashed_shuttle/graysontug)
"aK" = (/obj/machinery/power/port_gen/pacman{anchored = 1; sheets = 25},/obj/structure/cable/yellow{d2 = 8; icon_state = "0-8"},/obj/machinery/alarm{req_access = list(); dir = 8; pixel_x = 24},/turf/simulated/floor/warhammer/splate,/area/map_template/crashed_shuttle/graysontug)
"aL" = (/obj/item/fluff_items/skull,/turf/template_noop,/area/map_template/crashed_shuttle/crash)
"aM" = (/obj/item/clothing/head/hardhat/bondsman,/obj/gibspawner/robot,/turf/template_noop,/area/template_noop)
"aN" = (/obj/decal/cleanable/blood/gibs/core,/turf/template_noop,/area/template_noop)
"aO" = (/obj/structure/cable/yellow{d1 = 1; d2 = 2; icon_state = "1-2"},/obj/machinery/door/airlock/external{id_tag = "graysontug_shuttle_outer"; frequency = 1380},/obj/machinery/atmospherics/pipe/manifold/hidden{dir = 8},/turf/simulated/floor/plating,/area/map_template/crashed_shuttle/graysontug)
"aP" = (/obj/decal/cleanable/liquid_fuel,/obj/decal/cleanable/generic,/obj/machinery/door/airlock/external{id_tag = "graysontug_shuttle_outer"; frequency = 1380},/obj/machinery/atmospherics/pipe/manifold/hidden{dir = 4; icon_state = "map"},/turf/simulated/floor/plating,/area/map_template/crashed_shuttle/graysontug)
"aQ" = (/obj/machinery/atmospherics/pipe/simple/hidden,/obj/machinery/atmospherics/pipe/simple/hidden/scrubbers,/obj/structure/closet/medical_wall/filled{pixel_x = -32},/obj/structure/bed/chair/shuttle/blue{dir = 4; icon_state = "shuttle_chair_preview"},/obj/item/storage/briefcase/inflatable,/turf/simulated/floor/warhammer/splate,/area/map_template/crashed_shuttle/graysontug)
"aR" = (/obj/machinery/power/terminal{dir = 4},/obj/structure/cable/yellow,/obj/machinery/atmospherics/pipe/simple/visible/universal,/turf/simulated/floor/warhammer/splate,/area/map_template/crashed_shuttle/graysontug)
"aS" = (/obj/machinery/power/smes/buildable/power_shuttle,/obj/structure/cable{d2 = 2; icon_state = "0-2"},/turf/simulated/floor/warhammer/splate,/area/map_template/crashed_shuttle/graysontug)
"aT" = (/obj/item/stack/material/rods,/turf/template_noop,/area/map_template/crashed_shuttle/crash)
"aU" = (/obj/decal/cleanable/blood/gibs/body,/turf/template_noop,/area/map_template/crashed_shuttle/crash)
"aV" = (/obj/rune/chaos/armor,/obj/structure/hivedecor/skulls,/turf/template_noop,/area/template_noop)
"aW" = (/obj/item/clothing/head/hardhat/bondsman,/turf/template_noop,/area/template_noop)
"aX" = (/obj/structure/railing/mapped{dir = 8; icon_state = "railing0-1"},/turf/simulated/floor/warhammer/splate,/area/map_template/crashed_shuttle/graysontug)
"aY" = (/obj/decal/cleanable/liquid_fuel,/obj/machinery/atmospherics/unary/vent_pump/high_volume/external_air{dir = 1; id_tag = "graysontug_shuttle_pump_out_external"},/obj/machinery/access_button/airlock_exterior{frequency = 1380; master_tag = "graysontug_shuttle"; pixel_x = -25; pixel_y = 30},/obj/item/remains/robot,/turf/simulated/floor/plating,/area/map_template/crashed_shuttle/graysontug)
"aZ" = (/obj/decal/cleanable/liquid_fuel,/obj/structure/fuel_port{pixel_x = 32},/obj/machinery/atmospherics/unary/vent_pump/high_volume/external_air{dir = 1; id_tag = "graysontug_shuttle_pump_out_external"},/obj/structure/closet/warhammer/iron_c,/obj/item/storage/toolbox/mechanical,/turf/simulated/floor/warhammer/splate,/area/map_template/crashed_shuttle/graysontug)
"ba" = (/obj/item/material/shard,/obj/machinery/atmospherics/pipe/simple/hidden,/obj/machinery/atmospherics/pipe/simple/hidden/scrubbers,/obj/structure/table/steel,/obj/item/clothing/glasses/blacksun/skitarii,/turf/simulated/floor/warhammer/splate,/area/map_template/crashed_shuttle/graysontug)
"bb" = (/obj/decal/cleanable/generic,/obj/machinery/atmospherics/binary/passive_gate{unlocked = 1; dir = 1},/turf/simulated/floor/warhammer/splate,/area/map_template/crashed_shuttle/graysontug)
"bc" = (/obj/structure/cable,/obj/machinery/power/apc/critical{dir = 4; name = "east bump"; pixel_x = 24; req_access = list("ACCESS_TAUSCOUT")},/obj/decal/cleanable/blood/gibs/robot/up,/turf/simulated/floor/warhammer/splate,/area/map_template/crashed_shuttle/graysontug)
"bd" = (/obj/gibspawner/human,/turf/template_noop,/area/map_template/crashed_shuttle/crash)
"be" = (/obj/decal/cleanable/blood/gibs/limb,/turf/template_noop,/area/template_noop)
"bf" = (/obj/item/fluff_items/skull,/turf/template_noop,/area/template_noop)
"bg" = (/obj/item/stack/material/rods,/obj/machinery/atmospherics/pipe/simple/visible/red{dir = 6},/turf/simulated/floor/warhammer/tunneldirty,/area/map_template/crashed_shuttle/graysontug)
"bh" = (/obj/decal/cleanable/liquid_fuel,/obj/machinery/atmospherics/pipe/simple/visible/universal{dir = 4},/obj/decal/cleanable/blood/gibs/robot,/turf/simulated/floor/warhammer/tunneldirty,/area/map_template/crashed_shuttle/graysontug)
"bi" = (/obj/decal/cleanable/liquid_fuel,/obj/machinery/atmospherics/pipe/simple/hidden/scrubbers{dir = 4},/obj/landmark/corpse/bloodpact,/turf/simulated/floor/warhammer/tunneldirty,/area/map_template/crashed_shuttle/graysontug)
"bj" = (/obj/item/stack/material/rods,/obj/machinery/atmospherics/pipe/simple/hidden/scrubbers{dir = 4},/obj/machinery/door/firedoor,/turf/simulated/floor/warhammer/splate,/area/map_template/crashed_shuttle/graysontug)
"bk" = (/obj/machinery/atmospherics/pipe/manifold/hidden{dir = 8},/obj/machinery/atmospherics/pipe/simple/hidden/scrubbers{dir = 9},/obj/machinery/constructable_frame/machine_frame,/obj/item/stock_parts/circuitboard/sleeper,/turf/simulated/floor/warhammer/splate,/area/map_template/crashed_shuttle/graysontug)
"bl" = (/obj/decal/cleanable/liquid_fuel,/obj/machinery/atmospherics/pipe/simple/visible/cyan{dir = 9; icon_state = "intact"},/obj/decal/cleanable/blood/gibs/down,/turf/simulated/floor/warhammer/splate,/area/map_template/crashed_shuttle/graysontug)
"bm" = (/obj/decal/cleanable/blood/splatter,/obj/structure/hivedecor/xenos/artifact/teslatower,/turf/simulated/floor/warhammer/tunneldirty,/area/map_template/crashed_shuttle/graysontug)
"bn" = (/turf/simulated/floor/warhammer/tunneldirty,/area/map_template/crashed_shuttle/graysontug)
"bo" = (/obj/item/fluff_items/skull,/obj/item/clothing/mask/gas/techpriest/skitarius{canremove = 1},/turf/template_noop,/area/map_template/crashed_shuttle/crash)
"bp" = (/obj/item/handcuffs,/turf/template_noop,/area/template_noop)
"bq" = (/obj/decal/cleanable/liquid_fuel,/turf/simulated/floor/exoplanet/barren,/area/map_template/crashed_shuttle/crash)
"br" = (/obj/decal/cleanable/liquid_fuel,/obj/machinery/atmospherics/pipe/simple/visible/red,/turf/simulated/floor/warhammer/tunneldirty,/area/map_template/crashed_shuttle/graysontug)
"bs" = (/obj/decal/cleanable/liquid_fuel,/obj/machinery/atmospherics/pipe/simple/visible/fuel{dir = 6},/obj/decal/cleanable/blood/gibs/core,/turf/simulated/floor/warhammer/lfloorscorched1,/area/map_template/crashed_shuttle/graysontug)
"bt" = (/obj/machinery/atmospherics/pipe/simple/visible/fuel{dir = 10},/obj/structure/closet/crate/warhammer/biohazard,/obj/item/reagent_containers/hypospray/autoinjector/pain,/obj/item/reagent_containers/hypospray/autoinjector/combatstim,/obj/item/reagent_containers/hypospray/autoinjector/coagulant,/turf/simulated/floor/warhammer/tunneldirty,/area/map_template/crashed_shuttle/graysontug)
"bu" = (/obj/item/material/shard,/obj/machinery/door/firedoor,/turf/simulated/floor/plating,/area/map_template/crashed_shuttle/graysontug)
"bv" = (/obj/item/stack/material/rods,/obj/machinery/atmospherics/pipe/manifold/hidden{dir = 8},/turf/simulated/floor/warhammer/splate,/area/map_template/crashed_shuttle/graysontug)
"bw" = (/obj/machinery/atmospherics/pipe/simple/hidden{dir = 4},/obj/item/clothing/mask/gas/security/bloodpact,/turf/simulated/floor/warhammer/tunneldirty,/area/map_template/crashed_shuttle/graysontug)
"bx" = (/obj/machinery/atmospherics/pipe/simple/hidden{dir = 10; icon_state = "intact"},/obj/random/loot/raregunsenergy,/turf/simulated/floor/warhammer/tunneldirty,/area/map_template/crashed_shuttle/graysontug)
"by" = (/obj/item/robot_parts/r_arm,/turf/template_noop,/area/map_template/crashed_shuttle/crash)
"bz" = (/obj/decal/cleanable/liquid_fuel,/obj/structure/railing/mapped{dir = 8; icon_state = "railing0-1"},/obj/machinery/atmospherics/portables_connector{dir = 1},/obj/structure/hivedecor/xenos/barrel/yellow,/turf/simulated/floor/warhammer/tunneldirty,/area/map_template/crashed_shuttle/graysontug)
"bA" = (/obj/decal/cleanable/liquid_fuel,/obj/machinery/atmospherics/binary/pump{dir = 1},/obj/decal/cleanable/blood/oil,/turf/simulated/floor/warhammer/tunneldirty,/area/map_template/crashed_shuttle/graysontug)
"bB" = (/obj/machinery/shipsensors,/obj/machinery/atmospherics/pipe/simple/visible/fuel,/obj/item/remains/robot,/turf/simulated/floor/warhammer/tunneldirty,/area/map_template/crashed_shuttle/graysontug)
"bC" = (/obj/paint/red,/obj/structure/sign/warning/biohazard,/obj/item/remains/robot,/turf/simulated/wall/titanium,/area/map_template/crashed_shuttle/graysontug)
"bD" = (/obj/machinery/atmospherics/unary/tank/air{start_pressure = 8000; dir = 1},/turf/simulated/floor/warhammer/splate,/area/map_template/crashed_shuttle/graysontug)
"bE" = (/obj/machinery/atmospherics/pipe/simple/hidden,/obj/machinery/door/airlock/external{id_tag = "graysontugrear_shuttle_inner"; frequency = 1380},/obj/machinery/access_button/airlock_exterior{frequency = 1380; master_tag = "graysontugrear_shuttle"; pixel_x = -25},/turf/simulated/floor/warhammer/tunneldirty,/area/map_template/crashed_shuttle/graysontug)
"bF" = (/turf/simulated/floor/exoplanet/barren,/area/map_template/crashed_shuttle/crash)
"bG" = (/obj/decal/cleanable/blood/gibs,/turf/template_noop,/area/template_noop)
"bH" = (/obj/structure/kitchenspike/improvised,/obj/structure/sign/chaos,/turf/template_noop,/area/template_noop)
"bI" = (/obj/decal/cleanable/liquid_fuel,/obj/structure/railing/mapped{dir = 8; icon_state = "railing0-1"},/obj/machinery/atmospherics/pipe/simple/visible/fuel{dir = 6},/obj/random/tool,/turf/simulated/floor/warhammer/lfloorscorched1,/area/map_template/crashed_shuttle/graysontug)
"bJ" = (/obj/decal/cleanable/liquid_fuel,/obj/machinery/atmospherics/pipe/manifold/visible/fuel{dir = 4},/turf/simulated/floor/warhammer/tunneldirty,/area/map_template/crashed_shuttle/graysontug)
"bK" = (/obj/machinery/atmospherics/pipe/simple/visible/fuel{dir = 5},/obj/paint/black,/turf/simulated/wall/titanium,/area/map_template/crashed_shuttle/graysontug)
"bL" = (/obj/machinery/atmospherics/pipe/manifold/visible/fuel{dir = 1},/obj/paint/black,/turf/simulated/wall/titanium,/area/map_template/crashed_shuttle/graysontug)
"bM" = (/obj/machinery/atmospherics/pipe/simple/visible/fuel{dir = 10},/obj/paint/black,/turf/simulated/wall/titanium,/area/map_template/crashed_shuttle/graysontug)
"bN" = (/obj/paint/black,/turf/simulated/wall/titanium,/area/map_template/crashed_shuttle/graysontug)
"bO" = (/obj/decal/cleanable/generic,/obj/structure/handrail{dir = 8; icon_state = "handrail"},/obj/machinery/atmospherics/unary/vent_pump/high_volume/external_air{dir = 1; id_tag = "graysontugrear_shuttle_pump"},/obj/machinery/embedded_controller/radio/airlock/docking_port{cycle_to_external_air = 1; dir = 4; frequency = 1380; id_tag = "graysontugrear_shuttle"; pixel_x = -22; pixel_y = 4; tag_exterior_door = "graysontugrear_shuttle_outer"; tag_interior_door = "graysontugrear_shuttle_inner"; tag_exterior_sensor = "graysontugrear_shuttle_exterior_sensor"; tag_chamber_sensor = "graysontugrear_shuttle_sensor"; tag_airpump = "graysontugrear_shuttle_pump"; tag_interior_sensor = "graysontugrear_shuttle_interior_sensor"},/turf/simulated/floor/warhammer/tunneldirty,/area/map_template/crashed_shuttle/graysontug)
"bP" = (/obj/paint/red,/obj/structure/sign/mechanicus,/turf/simulated/wall/titanium,/area/map_template/crashed_shuttle/graysontug)
"bQ" = (/obj/landmark/corpse/bloodpact,/turf/simulated/floor/exoplanet/barren,/area/map_template/crashed_shuttle/crash)
"bR" = (/obj/decal/cleanable/vomit,/turf/template_noop,/area/template_noop)
"bS" = (/obj/decal/cleanable/liquid_fuel,/obj/structure/railing/mapped,/obj/machinery/atmospherics/portables_connector{dir = 1},/turf/simulated/floor/warhammer/lfloorscorched1,/area/map_template/crashed_shuttle/graysontug)
"bT" = (/obj/decal/cleanable/liquid_fuel,/obj/item/stack/material/rods,/obj/machinery/atmospherics/portables_connector{dir = 1},/obj/machinery/portable_atmospherics/canister/carbon_dioxide/engine_setup{start_pressure = 7498},/turf/simulated/floor/warhammer/lfloorscorched1,/area/map_template/crashed_shuttle/graysontug)
"bU" = (/obj/structure/girder,/turf/simulated/floor/warhammer/tunneldirty,/area/map_template/crashed_shuttle/graysontug)
"bV" = (/obj/machinery/atmospherics/unary/engine{dir = 1},/turf/simulated/floor/warhammer/tunneldirty,/area/map_template/crashed_shuttle/graysontug)
"bW" = (/obj/machinery/door/airlock/external{id_tag = "graysontugrear_shuttle_outer"; frequency = 1380},/obj/machinery/access_button/airlock_exterior{frequency = 1380; master_tag = "graysontugrear_shuttle"; pixel_x = -25},/turf/simulated/floor/warhammer/tunneldirty,/area/map_template/crashed_shuttle/graysontug)
"bX" = (/obj/decal/cleanable/generic,/turf/simulated/floor/exoplanet/barren,/area/map_template/crashed_shuttle/crash)
"bY" = (/obj/item/stool/padded,/turf/template_noop,/area/map_template/crashed_shuttle/crash)
"bZ" = (/obj/item/campfire,/turf/template_noop,/area/template_noop)
"ca" = (/obj/item/gun/energy/lasgun/laspistol/militarum/bloodpact,/obj/decal/cleanable/blood/drip,/turf/simulated/floor/exoplanet/barren,/area/map_template/crashed_shuttle/crash)
"cb" = (/obj/gibspawner/human,/obj/item/stool/padded,/turf/template_noop,/area/template_noop)
"cc" = (/obj/structure/cargopile,/turf/template_noop,/area/map_template/crashed_shuttle/crash)
"cd" = (/obj/decal/cleanable/liquid_fuel,/obj/decal/cleanable/blood/gibs/limb,/turf/simulated/floor/exoplanet/barren,/area/map_template/crashed_shuttle/crash)
"ce" = (/obj/decal/cleanable/liquid_fuel,/obj/structure/hivedecor/scrapper,/turf/simulated/floor/exoplanet/barren,/area/map_template/crashed_shuttle/crash)
"cf" = (/obj/landmark/corpse/bloodpact/commando,/turf/simulated/floor/exoplanet/barren,/area/map_template/crashed_shuttle/crash)
"cg" = (/obj/decal/cleanable/blood/gibs,/obj/item/clothing/head/helmet/flak/chaos/alt,/obj/item/gun/energy/lasgun/laspistol/militarum/bloodpact,/turf/simulated/floor/exoplanet/barren,/area/map_template/crashed_shuttle/crash)
"ch" = (/obj/structure/cargopile,/turf/simulated/floor/exoplanet/barren,/area/map_template/crashed_shuttle/crash)
"ci" = (/obj/machinery/portable_atmospherics/canister/empty/carbon_dioxide,/turf/template_noop,/area/map_template/crashed_shuttle/crash)
"cj" = (/obj/structure/closet/crate/warhammer/cargo,/obj/random/loot/randomcolonyitems,/obj/item/clothing/head/helmet/flak/chaos,/turf/simulated/floor/exoplanet/barren,/area/map_template/crashed_shuttle/crash)
"ck" = (/obj/random/toolbox,/turf/simulated/floor/exoplanet/barren,/area/map_template/crashed_shuttle/crash)
"cl" = (/obj/machinery/portable_atmospherics/canister/empty/oxygen,/turf/template_noop,/area/map_template/crashed_shuttle/crash)
"cm" = (/obj/structure/closet/crate/warhammer/cargo,/obj/random/loot/randomsupply,/turf/template_noop,/area/map_template/crashed_shuttle/crash)

(1,1,1) = {"
aaaaaaaaaaaaaaaaaaaaaaaaababab
aaaaaaaaaaacadaeafagahaaababab
aaaaaiaiacadajakalamanaaaoabab
aaapagaqarasatauavawaaaaababab
aaaaasaxayazaAaBaCasaDaEababab
aaaaaFaGaHasaIaJaKasaaaLaMaNab
aaanasaOaPasaQaRaSasaTaUaVaWab
aaaaaXaYaZasbabbbcasaabdbebfab
aaaabgbhbibjbkblbmbnaaboababbp
anbqbrbsbtbubvbwbxadbyaaababab
aabqbzbAbBbCbDasbEasbFaabGbHab
aabqbIbJbKbLbMbNbObPbQaaababbR
bqbqbSbTbUbVbVbNbWasbXbYbZabab
aTbqbqbqbqbqbFbFbFcabFaaabcbab
aacccdbqcecfbXcgchbFbFbXaaabab
aaciaaaaaaaaaaaacjbFckbFclaaab
ababababababaaaaaaaaccaaaaaaab
ababababaNababababaaaaaaaaaaab
ababababababababababaaaacmaaab
ababababababababababababababab
"}
