//MAP CONVERTED BY dmm2tgm.py THIS HEADER COMMENT PREVENTS RECONVERSION, DO NOT REMOVE
"a" = (
/turf/simulated/mineral/random,
/area/space)
"b" = (
/obj/decal/cleanable/blood,
/turf/simulated/floor/asteroid,
/area/space)
"k" = (
/obj/decal/cleanable/blood,
/obj/decal/cleanable/blood,
/turf/simulated/floor/asteroid,
/area/space)
"m" = (
/obj/item/shovel,
/turf/simulated/floor/asteroid,
/area/space)
"p" = (
/obj/item/pickaxe,
/turf/simulated/floor/asteroid,
/area/space)
"q" = (
/obj/random/loot/lootartifacts,
/turf/simulated/mineral/random,
/area/space)
"t" = (
/obj/item/device/flashlight/lantern,
/turf/simulated/floor/asteroid,
/area/space)
"v" = (
/obj/structure/sign/chaos,
/turf/simulated/floor/asteroid,
/area/space)
"w" = (
/turf/unsimulated/mineral,
/area/space)
"H" = (
/obj/structure/hivedecor/floodlight,
/turf/simulated/floor/asteroid,
/area/space)
"I" = (
/obj/decal/cleanable/blood,
/obj/decal/cleanable/remains,
/turf/simulated/floor/asteroid,
/area/space)
"J" = (
/turf/simulated/floor/asteroid,
/area/space)
"T" = (
/obj/random/loot/lootartifacts,
/turf/simulated/floor/asteroid,
/area/space)
"Y" = (
/obj/structure/ladder/up{
	id = mining_chaossite
	},
/turf/simulated/floor/asteroid,
/area/space)

(1,1,1) = {"
w
w
w
w
w
w
w
w
w
w
w
w
w
w
w
w
w
w
w
w
w
w
w
w
w
w
w
w
w
w
w
w
w
w
w
w
w
w
w
w
w
w
w
w
w
w
w
w
w
w
w
w
w
w
w
w
w
w
w
w
w
w
w
w
w
w
w
w
w
w
w
w
w
w
w
w
w
w
w
w
w
w
w
w
w
w
w
w
w
w
w
w
w
w
w
w
w
w
w
w
"}
(2,1,1) = {"
w
a
a
a
a
a
a
a
a
a
a
a
a
a
a
a
a
a
a
a
a
a
a
a
a
a
a
a
a
a
a
a
a
a
a
a
a
a
a
a
a
a
a
a
a
a
a
a
a
a
a
a
a
a
a
a
a
a
a
a
a
a
a
a
a
a
a
a
a
a
a
a
a
a
a
a
a
a
a
a
a
a
a
a
a
a
a
a
a
a
a
a
a
a
a
a
a
a
a
w
"}
(3,1,1) = {"
w
a
a
a
a
a
a
a
a
a
a
a
a
a
a
a
a
a
a
a
a
a
a
a
a
a
a
a
a
a
a
a
a
a
a
a
a
a
a
a
a
a
a
a
a
a
a
a
a
a
a
a
a
a
a
a
a
a
a
a
a
a
a
a
a
a
a
a
a
a
a
a
a
a
a
a
a
a
a
a
a
a
a
a
a
a
a
a
a
a
a
a
a
a
a
a
a
a
a
w
"}
(4,1,1) = {"
w
a
a
a
a
a
a
a
a
a
a
a
a
a
a
a
a
a
a
a
a
a
a
a
a
a
a
a
a
a
a
a
a
a
a
a
a
a
a
a
a
a
a
a
a
a
a
a
a
a
a
a
a
a
a
a
a
a
a
a
a
a
a
a
a
a
a
a
a
a
a
a
a
a
a
a
a
a
a
a
a
a
a
a
a
a
a
a
a
a
a
a
a
a
a
a
a
a
a
w
"}
(5,1,1) = {"
w
a
a
a
a
a
a
a
a
a
a
a
a
a
a
a
a
a
a
a
a
a
a
a
a
a
a
a
a
a
a
a
a
a
a
a
a
a
a
a
a
a
a
a
a
a
a
a
a
a
a
a
a
a
a
a
a
a
a
a
a
a
a
a
a
a
a
a
a
a
a
a
a
a
a
a
a
a
a
a
a
a
a
a
a
a
a
a
a
a
a
a
a
a
a
a
a
a
a
w
"}
(6,1,1) = {"
w
a
a
a
a
a
a
a
a
a
a
a
a
a
a
a
a
a
a
a
a
a
a
a
a
a
a
a
a
a
a
a
a
a
a
a
a
a
a
a
a
a
a
a
a
a
a
a
a
a
a
a
a
a
a
a
a
a
a
a
a
a
a
a
a
a
a
a
a
a
a
a
a
a
a
a
a
a
a
a
a
a
a
a
a
a
a
a
a
a
a
a
a
a
a
a
a
a
a
w
"}
(7,1,1) = {"
w
a
a
a
a
a
a
a
a
a
a
a
a
a
a
a
a
a
a
a
a
a
a
a
a
a
a
a
a
a
a
a
a
a
a
a
a
a
a
a
a
a
a
a
a
a
a
a
a
a
a
a
a
a
a
a
a
a
a
a
a
a
a
a
a
a
a
a
a
a
a
a
a
a
a
a
a
a
a
a
a
a
a
a
a
a
a
a
a
a
a
a
a
a
a
a
a
a
a
w
"}
(8,1,1) = {"
w
a
a
a
a
a
a
a
a
a
a
a
a
a
a
a
a
a
a
a
a
a
a
a
a
a
a
a
a
a
a
a
a
a
a
a
a
a
a
a
a
a
a
a
a
a
a
a
a
a
a
a
a
a
a
a
a
a
a
a
a
a
a
a
a
a
a
a
a
a
a
a
a
a
a
a
a
a
a
a
a
a
a
a
a
a
a
a
a
a
a
a
a
a
a
a
a
a
a
w
"}
(9,1,1) = {"
w
a
a
a
a
a
a
a
a
a
a
a
a
a
a
a
a
a
a
a
a
a
a
a
a
a
a
a
a
a
a
a
a
a
a
a
a
a
a
a
a
a
a
a
a
a
a
a
a
a
a
a
a
a
a
a
a
a
a
a
a
a
a
a
a
a
a
a
a
a
a
a
a
a
a
a
a
a
a
a
a
a
a
a
a
a
a
a
a
a
a
a
a
a
a
a
a
a
a
w
"}
(10,1,1) = {"
w
a
a
a
a
a
a
a
a
a
a
a
a
a
a
a
a
a
a
a
a
a
a
a
a
a
a
a
a
a
a
a
a
a
a
a
a
a
a
a
a
a
a
a
a
a
a
a
a
a
a
a
a
a
a
a
a
a
a
a
a
a
a
a
a
a
a
a
a
a
a
a
a
a
a
a
a
a
a
a
a
a
a
a
a
a
a
a
a
a
a
a
a
a
a
a
a
a
a
w
"}
(11,1,1) = {"
w
a
a
a
a
a
a
a
a
a
a
a
a
a
a
a
a
a
a
a
a
a
a
a
a
a
a
a
a
a
a
a
a
a
a
a
a
a
a
a
a
a
a
a
a
a
a
a
a
a
a
a
a
a
a
a
a
a
a
a
a
a
a
a
a
a
a
a
a
a
a
a
a
a
a
a
a
a
a
a
a
a
a
a
a
a
a
a
a
a
a
a
a
a
a
a
a
a
a
w
"}
(12,1,1) = {"
w
a
a
a
a
a
a
a
a
a
a
a
a
a
a
a
a
a
a
a
a
a
a
a
a
a
a
a
a
a
a
a
a
a
a
a
a
a
a
a
a
a
a
a
a
a
a
a
a
a
a
a
a
a
a
a
a
a
a
a
a
a
a
a
a
a
a
a
a
a
a
a
a
a
a
a
a
a
a
a
a
a
a
a
a
a
a
a
a
a
a
a
a
a
a
a
a
a
a
w
"}
(13,1,1) = {"
w
a
a
a
a
a
a
a
a
a
a
a
a
a
a
a
a
a
a
a
a
a
a
a
a
a
a
a
a
a
a
a
a
a
a
a
a
a
a
a
a
a
a
a
a
a
a
a
a
a
a
a
a
a
a
a
a
a
a
a
a
a
a
a
a
a
a
a
a
a
a
a
a
a
a
a
a
a
a
a
a
a
a
a
a
a
a
a
a
a
a
a
a
a
a
a
a
a
a
w
"}
(14,1,1) = {"
w
a
a
a
a
a
a
a
a
a
a
a
a
a
a
a
a
a
a
a
a
a
a
a
a
a
a
a
a
a
a
a
a
a
a
a
a
a
a
a
a
a
a
a
a
a
a
a
a
a
a
a
a
a
a
a
a
a
a
a
a
a
a
a
a
a
a
a
a
a
a
a
a
a
a
a
a
a
a
a
a
a
a
a
a
a
a
a
a
a
a
a
a
a
a
a
a
a
a
w
"}
(15,1,1) = {"
w
a
a
a
a
a
a
a
a
a
a
a
a
a
a
a
a
a
a
a
a
a
a
a
a
a
a
a
a
a
a
a
a
a
a
a
a
a
a
a
a
a
a
a
a
a
a
a
a
a
a
a
a
a
a
a
a
a
a
a
a
a
a
a
a
a
a
a
a
a
a
a
a
a
a
a
a
a
a
a
a
a
a
a
a
a
a
a
a
a
a
a
a
a
a
a
a
a
a
w
"}
(16,1,1) = {"
w
a
a
a
a
a
a
a
a
a
a
a
a
a
a
a
a
a
a
a
a
a
a
a
a
a
a
a
a
a
a
a
a
a
a
a
a
a
a
a
a
a
a
a
a
a
a
a
a
a
a
a
a
a
a
a
a
a
a
a
a
a
a
a
a
a
a
a
a
a
a
a
a
a
a
a
a
a
a
a
a
a
a
a
a
a
a
a
a
a
a
a
a
a
a
a
a
a
a
w
"}
(17,1,1) = {"
w
a
a
a
a
a
a
a
a
a
a
a
a
a
a
a
a
a
a
a
a
a
a
a
a
a
a
a
a
a
a
a
a
a
a
a
a
a
a
a
a
a
a
a
a
a
a
a
a
a
a
a
a
a
a
a
a
a
a
a
a
a
a
a
a
a
a
a
a
a
a
a
a
a
a
a
a
a
a
a
a
a
a
a
a
a
a
a
a
a
a
a
a
a
a
a
a
a
a
w
"}
(18,1,1) = {"
w
a
a
a
a
a
a
a
a
a
a
a
a
a
a
a
a
a
a
a
a
a
a
a
a
a
a
a
a
a
a
a
a
a
a
a
a
a
a
a
a
a
a
a
a
a
a
a
a
a
a
a
a
a
a
a
a
a
a
a
a
a
a
a
a
a
a
a
a
a
a
a
a
a
a
a
a
a
a
J
J
J
a
a
a
a
a
a
a
a
a
a
a
a
a
a
a
a
a
w
"}
(19,1,1) = {"
w
a
a
a
a
a
a
a
a
a
a
a
a
a
a
a
a
a
a
a
a
a
a
a
a
a
a
a
a
a
a
a
a
a
a
a
a
a
a
a
a
a
a
a
a
a
a
a
a
a
a
a
a
a
a
a
a
a
a
a
a
a
a
a
a
a
a
a
a
a
a
a
a
a
a
a
a
a
a
a
a
a
a
a
a
a
a
a
a
a
a
a
a
a
a
a
a
a
a
w
"}
(20,1,1) = {"
w
a
a
a
a
a
a
a
a
a
a
a
a
a
a
a
a
a
a
a
a
a
a
a
a
a
a
a
a
a
a
a
a
a
a
a
a
a
a
a
a
a
a
a
a
a
a
a
a
a
a
a
a
a
a
a
a
a
a
a
a
a
a
a
a
a
a
a
a
a
a
a
a
a
a
a
a
J
J
J
J
J
a
a
a
a
a
a
a
a
a
a
a
a
a
a
a
a
a
w
"}
(21,1,1) = {"
w
a
a
a
a
a
a
a
a
a
a
a
a
a
a
a
a
a
a
a
a
a
a
a
a
a
a
a
a
a
a
a
a
a
a
a
a
a
a
a
a
a
a
a
a
a
a
a
a
a
a
a
a
a
J
J
J
a
a
a
a
a
a
a
a
a
a
a
a
a
a
a
a
a
a
a
a
J
J
J
a
a
J
J
a
a
a
a
a
a
a
a
a
a
a
a
a
a
a
w
"}
(22,1,1) = {"
w
a
a
a
a
a
a
a
a
a
a
a
a
a
a
a
a
a
a
a
a
a
a
a
a
a
a
a
a
a
a
a
a
a
a
a
a
a
a
a
a
a
a
a
a
a
a
a
a
a
a
a
a
a
a
a
a
J
J
a
a
J
J
a
a
a
a
a
a
a
a
a
a
a
a
a
a
a
a
J
J
J
a
a
a
a
a
a
a
a
a
a
a
a
a
a
a
a
a
w
"}
(23,1,1) = {"
w
a
a
a
a
a
a
a
a
a
a
a
a
a
a
a
a
a
a
a
a
a
a
a
a
a
a
a
a
a
a
a
a
a
a
a
a
a
a
a
a
a
a
a
a
a
a
a
T
a
a
a
a
J
J
a
J
a
J
J
J
J
a
a
a
J
J
J
a
J
a
a
a
a
a
a
J
J
J
a
J
a
a
a
a
a
a
a
a
a
a
a
a
a
a
a
a
a
a
w
"}
(24,1,1) = {"
w
a
a
a
a
a
a
a
a
a
a
a
a
a
a
a
a
a
a
a
a
a
a
a
a
a
a
a
a
a
a
a
a
a
a
a
a
a
a
a
a
a
a
a
a
a
a
J
J
J
J
J
J
J
J
J
J
a
J
J
J
J
J
J
J
a
J
J
a
J
J
J
J
a
J
J
a
J
a
J
a
a
a
a
a
a
a
a
a
a
a
a
a
a
a
a
a
a
a
w
"}
(25,1,1) = {"
w
a
a
a
a
a
a
a
a
a
a
a
a
a
a
a
a
a
a
a
a
a
a
a
a
a
a
a
a
a
a
a
a
a
a
a
a
a
a
a
a
a
a
a
a
a
a
J
J
J
J
J
J
J
J
J
J
J
J
J
J
J
J
J
J
J
J
a
J
J
J
J
J
a
J
J
J
J
J
a
a
a
a
a
a
a
a
a
a
a
a
a
a
a
a
a
a
a
a
w
"}
(26,1,1) = {"
w
a
a
a
a
a
a
a
a
a
a
a
a
a
a
a
a
a
a
a
a
a
a
a
a
a
a
a
a
a
a
a
a
a
a
a
a
a
a
a
a
a
a
a
a
J
J
J
J
J
J
J
a
a
a
a
a
a
a
a
a
a
a
J
J
J
J
J
J
J
J
J
J
a
J
J
J
J
a
a
a
a
a
a
a
a
a
a
a
a
a
a
a
a
a
a
a
a
a
w
"}
(27,1,1) = {"
w
a
a
a
a
a
a
a
a
a
a
a
a
a
a
a
a
a
a
a
a
a
a
a
a
a
a
a
a
a
a
a
a
a
a
a
a
a
a
a
a
a
a
J
a
J
J
J
J
J
J
J
J
a
a
a
a
a
a
a
a
a
a
a
a
J
J
J
J
J
J
a
J
J
J
J
a
a
a
a
a
a
a
a
a
a
a
a
a
a
a
a
a
a
a
a
a
a
a
w
"}
(28,1,1) = {"
w
a
a
a
a
a
a
a
a
a
a
a
a
a
a
a
a
a
a
a
a
a
a
a
a
a
a
a
a
a
a
a
a
a
a
a
a
a
a
a
J
a
a
J
J
J
J
J
a
J
a
a
a
a
a
a
a
a
a
a
a
a
a
a
a
a
a
a
J
J
J
J
J
J
J
J
a
a
a
a
a
a
a
a
a
a
a
a
a
a
a
a
a
a
a
a
a
a
a
w
"}
(29,1,1) = {"
w
a
a
a
a
a
a
a
a
a
a
a
a
a
a
a
a
a
a
a
a
a
a
a
a
a
a
a
a
a
a
a
a
a
a
a
a
a
a
a
a
a
a
J
J
J
J
a
a
a
a
a
a
a
a
a
a
a
a
a
a
a
a
a
a
a
a
a
a
J
J
J
J
J
a
a
a
a
a
a
a
a
a
a
a
a
a
a
a
a
a
a
a
a
a
a
a
a
a
w
"}
(30,1,1) = {"
w
a
a
a
a
a
a
a
a
a
a
a
a
a
a
a
a
a
a
a
a
a
a
a
a
a
a
a
a
a
a
a
a
a
a
a
a
a
a
J
a
a
J
J
J
J
a
a
J
a
a
a
a
a
a
a
a
a
a
a
a
a
a
a
a
a
a
a
a
J
J
J
J
J
a
a
a
a
a
a
a
a
a
a
a
a
a
a
a
a
a
a
a
a
a
a
a
a
a
w
"}
(31,1,1) = {"
w
a
a
a
a
a
a
a
a
a
a
a
a
a
a
a
a
a
a
a
a
a
a
a
a
a
a
a
a
a
a
a
a
a
a
a
a
a
a
J
J
J
J
J
J
a
a
a
J
a
a
a
a
a
a
a
a
a
a
a
a
a
a
a
a
a
a
a
a
J
J
J
J
a
a
a
a
a
a
a
a
a
a
a
a
a
a
a
a
a
a
a
a
a
a
a
a
a
a
w
"}
(32,1,1) = {"
w
a
a
a
a
a
a
a
a
a
a
a
a
a
a
a
a
a
a
a
a
a
a
a
a
a
a
a
a
a
a
a
a
a
a
a
a
J
a
J
a
J
J
a
a
J
a
J
J
a
a
a
a
a
a
a
a
a
a
a
a
a
a
a
a
a
a
a
J
p
J
a
a
a
a
a
a
a
a
q
a
a
a
a
a
a
a
a
a
a
a
a
a
a
a
a
a
a
a
w
"}
(33,1,1) = {"
w
a
a
a
a
a
a
a
a
a
a
a
a
a
a
a
a
a
a
a
a
a
a
a
a
a
a
a
a
a
a
a
a
a
a
J
J
a
a
a
J
J
J
J
a
a
a
a
J
a
a
a
a
a
a
a
a
a
a
a
a
a
a
a
a
a
a
a
J
J
J
J
a
a
a
a
a
a
a
a
a
a
a
a
a
a
a
a
a
a
a
a
a
a
a
a
a
a
a
w
"}
(34,1,1) = {"
w
a
a
a
a
a
a
a
a
a
a
a
a
a
a
a
a
a
a
a
a
a
a
a
a
a
a
a
a
a
a
a
a
a
a
a
a
J
a
J
J
J
a
J
a
a
a
a
a
a
a
a
a
a
a
a
a
a
a
a
a
a
a
a
a
a
J
J
J
J
J
a
a
a
a
a
a
a
a
a
a
a
a
a
a
a
a
a
a
a
a
a
a
a
a
a
a
a
a
w
"}
(35,1,1) = {"
w
a
a
a
a
a
a
a
a
a
a
a
a
a
a
a
a
a
a
a
a
a
a
a
a
a
a
a
a
a
a
a
a
a
a
a
a
a
a
J
J
a
a
J
a
a
a
a
a
a
a
a
a
a
a
a
a
a
a
a
a
a
a
a
a
a
J
J
a
J
J
a
a
a
a
a
a
a
a
a
a
a
a
a
a
a
a
a
a
a
a
a
a
a
a
a
a
a
a
w
"}
(36,1,1) = {"
w
a
a
a
a
a
a
a
a
a
a
a
a
a
a
a
a
a
a
a
a
a
q
a
a
a
a
a
a
a
a
a
a
J
a
a
J
J
J
J
J
J
J
J
a
a
a
a
a
a
a
a
a
a
a
a
a
a
a
a
a
a
a
J
J
J
J
J
J
a
J
a
a
a
a
a
a
a
a
a
a
a
a
a
a
a
a
a
a
a
a
a
a
a
a
a
a
a
a
w
"}
(37,1,1) = {"
w
a
a
a
a
a
a
a
a
a
a
a
a
a
a
a
a
a
a
a
a
a
a
a
a
a
a
a
a
a
a
a
J
J
a
a
p
a
J
J
J
J
J
J
a
a
a
a
a
a
a
a
a
a
a
a
a
a
a
a
a
a
a
a
a
a
a
J
J
J
J
J
a
a
a
a
a
a
a
a
a
a
a
a
a
a
a
a
a
a
a
a
a
a
a
a
a
a
a
w
"}
(38,1,1) = {"
w
a
a
a
a
a
a
a
a
a
a
a
a
a
a
a
a
a
a
a
a
a
a
a
a
a
a
a
a
a
a
a
J
a
J
J
J
J
J
J
J
a
J
m
a
a
a
a
a
q
a
a
a
a
a
a
a
a
a
a
a
a
a
a
a
a
a
J
a
J
J
J
J
a
a
a
a
a
a
a
a
a
a
a
a
a
a
a
a
a
a
a
a
a
a
a
a
a
a
w
"}
(39,1,1) = {"
w
a
a
a
a
a
a
a
a
a
a
a
a
a
a
a
a
a
a
a
a
a
a
a
a
a
a
a
a
a
a
a
J
a
J
J
J
J
J
J
a
a
J
a
a
a
a
a
a
a
a
a
a
a
a
a
a
a
a
a
a
a
a
a
a
a
a
a
J
a
J
J
J
a
J
a
a
a
a
a
a
a
a
a
a
a
a
a
a
a
a
a
a
a
a
a
a
a
a
w
"}
(40,1,1) = {"
w
a
a
a
a
a
a
a
a
a
a
a
a
a
a
a
a
a
a
a
a
a
a
a
a
a
a
a
a
a
J
J
J
J
J
J
J
J
J
a
a
a
J
a
a
a
a
a
a
a
a
a
a
a
a
a
a
a
a
a
a
a
a
a
a
a
a
a
a
a
J
J
J
J
J
a
a
a
a
a
a
a
a
a
a
a
a
a
a
a
a
a
a
a
a
a
a
a
a
w
"}
(41,1,1) = {"
w
a
a
a
a
a
a
a
a
a
a
a
a
a
a
a
a
a
a
a
a
a
a
a
a
a
a
a
a
a
a
a
J
a
J
a
J
J
a
a
J
J
J
a
a
a
a
a
a
a
a
a
a
a
a
a
a
a
a
a
a
a
a
a
a
a
a
a
a
a
a
J
J
J
J
J
a
J
J
J
a
a
a
a
a
a
a
a
a
a
a
a
a
a
a
a
a
a
a
w
"}
(42,1,1) = {"
w
a
a
a
a
a
a
a
a
a
a
a
a
a
a
a
a
a
a
a
a
a
a
a
a
a
a
a
a
a
a
a
J
J
J
J
a
J
J
a
a
a
a
a
a
a
a
a
a
a
a
a
a
a
a
a
a
a
a
a
a
a
a
a
a
a
a
J
a
J
J
J
J
J
J
J
J
J
J
J
J
a
a
a
a
a
a
a
a
a
a
a
a
a
a
a
a
a
a
w
"}
(43,1,1) = {"
w
a
a
a
a
a
a
a
a
a
a
a
a
a
a
a
a
a
a
a
a
a
a
a
a
a
a
a
a
a
J
J
J
a
J
a
J
a
a
a
a
a
a
a
a
a
a
a
a
a
a
a
a
a
a
a
a
a
a
a
a
a
a
a
a
a
a
J
J
J
J
J
a
a
J
J
J
J
J
J
J
J
a
a
a
a
a
a
a
a
a
a
a
a
a
a
a
a
a
w
"}
(44,1,1) = {"
w
a
a
a
a
a
a
a
a
a
a
a
a
a
a
a
a
a
a
a
a
a
a
a
a
a
a
a
a
J
J
J
a
J
J
a
a
a
a
a
a
a
a
a
a
a
a
a
a
a
a
a
a
a
a
a
a
a
a
a
a
a
a
a
a
J
a
J
J
J
J
J
J
a
J
J
J
J
a
J
J
J
J
a
a
a
a
a
a
a
a
a
a
a
a
a
a
a
a
w
"}
(45,1,1) = {"
w
a
a
a
a
a
a
a
a
a
a
a
a
a
a
a
a
a
a
a
a
a
a
a
J
J
J
J
J
J
J
J
J
J
J
J
a
a
a
a
a
a
a
a
a
a
a
a
a
a
a
a
a
a
a
a
a
a
a
a
a
a
a
a
a
a
J
J
a
a
a
a
a
J
a
J
J
J
J
J
J
J
J
H
J
J
J
a
a
a
a
a
a
a
a
a
a
a
a
w
"}
(46,1,1) = {"
w
a
a
a
a
a
a
a
a
a
a
a
a
a
a
a
a
a
a
a
a
a
a
J
J
J
J
J
J
J
J
J
J
J
J
a
J
a
a
a
a
a
J
a
a
a
a
a
a
a
a
a
a
a
a
a
a
a
a
a
a
a
a
a
a
J
J
J
J
a
a
a
a
a
J
J
J
J
J
J
a
J
J
J
J
a
J
J
a
a
a
a
a
a
a
a
a
a
a
w
"}
(47,1,1) = {"
w
a
a
a
a
a
a
a
a
a
a
a
a
a
a
a
a
a
a
a
a
J
J
J
J
J
T
J
J
J
J
J
J
a
J
J
a
a
a
a
a
a
J
a
a
a
a
a
a
a
a
a
a
a
a
a
a
a
a
a
a
a
a
a
J
J
J
a
a
a
a
a
J
a
J
J
J
J
J
J
J
J
J
a
J
J
J
J
J
J
a
a
a
a
a
a
a
a
a
w
"}
(48,1,1) = {"
w
a
a
a
a
a
a
a
a
a
a
a
a
a
a
a
a
a
J
J
J
J
J
J
J
J
J
J
J
J
J
J
J
a
J
J
a
a
a
a
a
a
a
a
a
a
a
a
a
a
a
a
a
a
a
a
a
a
a
a
a
J
J
J
J
J
J
a
a
a
a
a
J
J
J
J
J
J
a
J
J
J
J
J
J
J
J
t
J
a
a
a
a
a
a
a
a
a
a
w
"}
(49,1,1) = {"
w
a
a
a
a
a
a
a
a
a
a
a
a
a
a
a
a
a
J
J
J
J
J
J
b
b
J
b
b
J
J
J
J
J
J
J
a
a
a
a
a
a
J
a
a
a
a
a
a
a
a
a
a
a
a
a
a
a
a
a
a
a
J
J
J
a
a
a
a
a
a
a
J
J
J
J
J
J
J
J
J
J
J
J
J
J
J
J
J
a
a
a
a
a
a
a
a
a
a
w
"}
(50,1,1) = {"
w
a
a
a
a
a
a
a
a
a
a
a
a
a
a
a
a
J
J
J
J
J
b
b
J
J
J
J
J
J
J
J
J
J
J
J
a
a
a
a
a
a
a
a
a
a
a
a
a
a
a
a
a
a
a
a
a
a
a
a
a
J
J
J
a
a
a
a
a
a
a
J
J
a
J
J
J
J
J
J
J
J
J
J
J
J
J
J
a
a
a
a
a
a
a
a
a
a
a
w
"}
(51,1,1) = {"
w
a
a
a
a
a
a
a
a
a
a
a
a
a
a
a
a
J
J
J
J
T
J
J
J
J
J
J
J
b
J
J
J
J
J
J
J
a
a
a
a
a
a
a
a
a
a
a
a
a
a
a
a
a
a
a
a
a
a
J
J
J
J
a
J
a
a
a
a
a
a
J
a
J
a
J
J
J
J
Y
p
J
J
J
J
J
J
J
a
a
a
a
a
a
a
a
a
a
a
w
"}
(52,1,1) = {"
w
a
a
a
a
a
a
a
a
a
a
a
a
a
a
a
a
J
J
J
J
J
b
J
I
b
b
J
J
J
T
J
J
J
J
J
J
a
J
a
a
a
a
a
a
a
a
a
a
a
a
a
a
a
a
a
a
J
a
J
J
a
J
a
a
a
a
a
a
a
a
J
J
J
J
a
J
J
J
J
J
J
J
J
J
J
J
J
J
a
a
a
a
a
a
a
a
a
a
w
"}
(53,1,1) = {"
w
a
a
a
a
a
a
a
a
a
a
a
a
a
a
a
a
J
J
J
J
J
b
J
I
v
I
J
b
J
J
J
J
J
J
J
J
J
J
J
a
a
a
a
a
a
a
a
a
a
a
a
a
a
a
a
a
J
a
J
J
a
J
a
a
a
a
a
a
a
a
J
J
J
J
J
J
J
J
J
J
J
J
J
J
J
J
J
J
a
a
a
a
a
a
a
a
a
a
w
"}
(54,1,1) = {"
w
a
a
a
a
a
a
a
a
a
a
a
a
a
a
a
a
a
J
J
J
J
J
J
b
b
b
J
J
J
J
J
J
J
J
J
J
J
J
J
J
J
J
J
a
a
a
a
a
a
a
a
a
a
a
a
a
J
J
J
a
a
a
a
a
a
a
a
a
a
a
J
a
J
J
J
J
J
J
J
J
J
J
J
J
J
J
J
a
a
a
a
a
a
a
a
a
a
a
w
"}
(55,1,1) = {"
w
a
a
a
a
a
a
a
a
a
a
a
a
a
a
a
a
a
J
J
J
J
b
J
J
J
J
J
b
J
J
J
J
J
J
a
J
J
J
J
J
J
J
J
J
J
J
a
a
a
a
a
a
a
a
a
J
J
J
J
J
J
a
a
a
a
a
a
a
a
a
J
J
J
J
J
J
J
J
J
J
J
J
J
J
J
H
a
a
a
a
a
a
a
a
a
a
a
a
w
"}
(56,1,1) = {"
w
a
a
a
a
a
a
a
a
a
a
a
a
a
a
a
a
a
J
J
J
J
J
J
J
J
J
k
b
J
J
J
J
J
a
a
a
a
J
a
J
J
J
J
J
J
J
J
J
J
a
J
J
a
a
a
J
J
a
J
a
a
a
a
a
a
a
a
a
a
a
a
J
a
H
J
J
J
J
J
J
J
J
J
J
J
a
J
J
a
a
a
a
a
a
a
a
a
a
w
"}
(57,1,1) = {"
w
a
a
a
a
a
a
a
a
a
a
a
a
a
a
a
a
a
J
J
J
T
J
b
b
J
b
J
J
J
J
J
a
a
a
a
a
a
a
a
a
a
a
a
a
a
a
a
J
J
J
J
J
J
a
a
J
J
a
a
a
a
a
a
a
a
a
a
a
a
a
a
J
a
a
J
J
J
J
J
J
J
a
J
J
J
J
J
J
J
a
a
a
a
a
a
a
a
a
w
"}
(58,1,1) = {"
w
a
a
a
a
a
a
a
a
a
a
a
a
a
a
a
a
a
J
J
J
J
J
J
J
J
J
J
J
J
T
J
a
J
a
a
a
a
a
a
a
a
a
a
a
a
a
a
a
a
J
J
J
J
J
J
J
J
a
a
a
a
a
a
a
a
a
a
a
a
a
a
a
a
a
J
J
J
J
a
J
a
J
J
J
a
J
J
J
J
J
J
J
a
a
a
a
a
a
w
"}
(59,1,1) = {"
w
a
a
a
a
a
a
a
a
a
a
a
a
a
a
a
a
a
J
J
J
J
J
J
J
J
J
J
J
J
J
a
a
J
a
a
a
a
a
a
a
a
a
a
a
a
a
a
a
a
a
a
J
J
J
J
a
a
a
a
a
a
a
a
a
a
a
a
a
a
a
a
a
a
a
J
J
J
a
J
J
a
J
a
a
a
a
a
a
a
J
J
J
J
a
a
a
a
a
w
"}
(60,1,1) = {"
w
a
a
a
a
a
a
a
a
a
a
a
a
a
a
a
a
a
a
a
J
J
J
J
J
J
J
J
J
J
J
a
J
J
a
a
a
a
a
a
a
a
a
a
a
a
a
a
a
a
a
a
a
a
J
J
J
J
J
a
a
a
a
a
a
a
a
a
a
a
a
a
a
a
J
J
J
J
J
a
J
J
J
a
a
a
a
a
a
a
a
a
J
a
a
a
a
a
a
w
"}
(61,1,1) = {"
w
a
a
a
a
a
a
a
a
a
a
a
a
a
a
a
a
a
a
a
a
J
J
J
J
J
J
J
J
a
J
J
a
a
a
a
a
a
a
a
a
a
a
a
a
a
a
a
a
a
a
a
a
a
J
J
J
a
a
a
a
a
a
a
a
a
a
a
a
a
a
a
a
a
J
J
a
a
J
J
J
a
a
a
J
a
a
a
a
a
a
a
a
a
a
a
a
a
a
w
"}
(62,1,1) = {"
w
a
a
a
a
a
a
a
a
a
a
a
a
a
a
a
a
a
a
a
a
a
J
J
J
J
J
J
a
a
J
a
a
a
a
a
a
a
a
a
a
a
a
a
a
a
a
a
a
a
a
a
a
a
J
J
a
a
a
a
a
a
a
a
a
a
a
a
a
a
a
a
a
a
J
J
a
a
a
a
a
a
a
J
a
a
a
a
a
a
a
a
a
a
a
a
a
a
a
w
"}
(63,1,1) = {"
w
a
a
a
a
a
a
a
a
a
a
a
a
a
a
a
a
a
a
a
a
J
J
J
J
J
J
J
a
a
a
a
a
a
a
a
a
a
a
a
a
a
a
a
a
a
a
a
a
a
a
a
a
a
J
J
a
a
a
a
a
a
a
a
a
a
a
a
a
a
a
a
a
J
J
a
a
a
a
a
a
a
a
a
a
a
a
a
a
a
a
a
a
a
a
a
a
a
a
w
"}
(64,1,1) = {"
w
a
a
a
a
a
a
a
a
a
a
a
a
a
a
a
a
a
a
a
a
a
a
J
J
J
a
J
a
a
a
a
a
a
a
a
a
a
a
a
a
a
a
a
a
a
a
a
a
a
a
a
a
a
a
J
J
a
a
a
a
a
a
a
a
a
a
a
a
a
a
a
a
J
J
a
a
a
a
a
a
a
a
a
a
a
a
a
a
a
a
a
a
a
a
a
a
a
a
w
"}
(65,1,1) = {"
w
a
a
a
a
a
a
a
a
a
a
a
a
a
a
a
a
a
a
a
J
a
a
J
J
J
a
a
a
a
a
a
a
a
a
a
a
a
a
a
a
a
a
a
a
a
a
a
a
a
a
a
a
a
J
J
a
a
a
a
a
a
a
a
a
a
a
a
a
a
a
a
J
J
a
a
a
a
a
a
a
a
a
a
a
a
a
a
a
a
a
a
a
a
a
a
a
a
a
w
"}
(66,1,1) = {"
w
a
a
a
a
a
a
a
a
a
a
a
a
a
a
a
q
a
a
a
a
a
a
J
a
J
a
a
a
a
a
a
a
a
a
a
a
a
a
a
a
a
a
a
a
a
a
a
a
a
a
a
a
a
a
t
J
a
a
a
a
a
a
a
a
a
a
a
a
a
J
J
J
J
J
a
a
a
a
a
a
a
a
a
a
a
a
a
a
a
a
a
a
a
a
a
a
a
a
w
"}
(67,1,1) = {"
w
a
a
a
a
a
a
a
a
a
a
a
a
a
a
a
a
a
a
a
a
a
J
J
J
a
a
a
a
a
a
a
a
a
a
a
a
a
a
a
q
a
a
a
a
a
a
a
a
a
a
a
J
J
a
J
J
a
a
a
a
a
a
a
a
a
J
J
J
J
J
J
J
J
J
J
a
a
a
a
a
a
a
a
a
a
a
a
a
a
a
a
a
a
a
a
a
a
a
w
"}
(68,1,1) = {"
w
a
a
a
a
a
a
a
a
a
a
a
a
a
a
a
a
a
a
a
a
J
J
J
J
a
a
a
a
a
a
a
a
a
a
a
a
a
a
a
a
a
a
a
a
a
a
a
a
a
a
a
a
a
a
J
J
a
J
a
J
a
a
a
p
J
J
J
J
J
J
J
a
J
J
J
J
a
a
a
a
a
a
a
a
a
a
a
a
a
a
a
a
a
a
a
a
a
a
w
"}
(69,1,1) = {"
w
a
a
a
a
a
a
a
a
a
a
a
a
a
a
a
a
a
a
a
a
a
J
J
J
a
a
a
a
a
a
a
a
a
a
a
a
a
a
a
a
a
a
a
a
a
a
a
a
a
a
J
J
J
J
J
J
J
J
J
J
J
J
J
J
J
J
a
J
a
a
a
a
a
a
J
J
a
a
a
a
a
a
a
a
a
a
a
a
a
a
a
a
a
a
a
a
a
a
w
"}
(70,1,1) = {"
w
a
a
a
a
a
a
a
a
a
a
a
a
a
a
a
a
a
a
a
a
J
J
J
a
a
a
a
a
a
a
a
a
a
a
a
a
a
a
a
a
a
a
a
a
a
a
a
a
a
a
a
a
J
J
J
J
J
J
a
a
a
J
J
a
a
a
a
a
a
a
a
a
a
J
J
J
J
J
a
a
a
a
a
a
a
a
a
a
a
a
a
a
a
a
a
a
a
a
w
"}
(71,1,1) = {"
w
a
a
a
a
a
a
a
a
a
a
a
a
a
a
a
a
a
a
a
J
J
a
a
a
a
a
a
a
a
a
a
a
a
a
a
a
a
a
a
a
a
a
a
a
a
a
a
a
a
a
a
J
J
J
a
J
a
J
J
a
a
J
J
a
a
a
a
a
a
a
a
a
a
J
a
J
J
a
a
a
a
a
a
a
a
a
a
a
a
a
a
a
a
a
a
a
a
a
w
"}
(72,1,1) = {"
w
a
a
a
a
a
a
a
a
a
a
a
a
a
a
a
a
a
a
J
J
J
a
a
a
a
a
a
a
a
a
a
a
a
a
a
a
a
a
a
a
a
a
a
J
a
a
a
J
a
J
J
J
a
J
a
J
a
a
J
J
J
J
J
a
a
a
a
a
a
a
a
a
a
a
a
J
J
J
a
a
a
a
a
a
a
a
a
a
a
a
a
a
a
a
a
a
a
a
w
"}
(73,1,1) = {"
w
a
a
a
a
a
a
a
a
a
a
a
a
a
a
a
a
a
a
J
J
J
a
a
a
a
a
a
a
a
a
a
a
a
a
a
a
a
a
a
a
a
a
a
a
a
J
J
J
J
a
a
J
a
a
J
J
a
a
a
a
J
J
J
J
J
a
a
a
a
a
a
a
a
a
a
a
J
J
a
a
a
a
a
a
a
a
a
a
a
a
a
a
a
a
a
a
a
a
w
"}
(74,1,1) = {"
w
a
a
a
a
a
a
a
a
a
a
a
a
a
a
a
a
a
J
J
J
J
a
a
a
a
a
a
a
a
a
a
a
a
a
a
a
a
a
a
a
a
a
a
a
J
J
J
J
J
J
J
J
a
J
a
a
a
a
a
a
a
a
a
J
J
J
a
a
a
a
a
a
a
a
a
a
a
J
J
a
a
a
a
a
a
a
a
a
a
a
a
a
a
a
a
a
a
a
w
"}
(75,1,1) = {"
w
a
a
a
a
a
a
a
a
a
a
a
a
a
a
a
a
a
J
J
J
J
J
a
a
a
a
a
a
a
a
a
a
a
a
a
a
a
J
a
J
a
J
J
J
J
J
a
J
a
a
a
a
a
a
a
a
a
a
a
a
a
a
a
J
J
a
a
a
a
a
a
a
a
a
a
a
a
J
J
a
a
a
a
a
a
a
a
a
a
a
a
a
a
a
a
a
a
a
w
"}
(76,1,1) = {"
w
a
a
a
a
a
a
a
a
a
a
a
a
a
a
a
a
J
J
J
J
J
J
a
a
a
a
a
a
a
a
a
a
a
a
a
a
a
J
J
J
J
J
J
J
J
J
a
a
a
a
J
a
a
a
a
a
a
a
a
a
a
a
J
a
J
J
a
a
a
a
a
a
a
a
a
a
a
J
J
a
a
J
a
J
a
a
a
a
a
a
a
a
a
a
a
a
a
a
w
"}
(77,1,1) = {"
w
a
a
a
a
a
a
a
a
a
a
a
a
a
a
a
a
J
a
J
J
J
a
a
a
a
a
a
a
a
a
a
a
a
a
a
a
J
J
J
J
J
J
a
J
a
a
a
a
a
a
a
a
a
a
a
a
a
a
a
a
a
a
a
a
a
J
J
J
a
a
a
a
a
a
a
a
J
a
J
a
a
J
a
a
a
a
a
a
a
a
a
a
a
a
a
a
a
a
w
"}
(78,1,1) = {"
w
a
a
a
a
a
a
a
a
a
a
a
a
a
a
a
a
J
J
m
J
J
a
a
a
a
a
a
a
a
a
a
a
a
a
a
J
J
p
J
J
J
J
a
a
a
a
a
a
a
a
a
a
a
a
a
a
a
a
a
a
a
a
a
a
J
J
J
J
a
a
a
a
a
a
a
a
a
a
J
J
J
a
a
a
a
a
a
a
a
a
a
a
a
a
a
a
a
a
w
"}
(79,1,1) = {"
w
a
a
a
a
a
a
a
a
a
a
a
a
a
a
a
J
a
J
J
J
J
J
J
J
J
J
J
J
a
a
a
a
J
J
J
J
J
J
J
J
J
T
a
J
a
a
a
a
a
a
a
a
a
a
a
q
a
a
a
a
a
a
a
a
a
a
J
J
J
J
a
a
a
a
a
a
m
a
J
J
J
a
J
T
a
a
a
a
a
a
a
a
a
a
a
a
a
a
w
"}
(80,1,1) = {"
w
a
a
a
a
a
a
a
a
a
a
a
a
a
a
a
J
a
J
J
J
J
J
J
J
J
J
J
J
J
J
a
J
J
J
J
J
J
J
J
a
a
a
a
a
a
a
a
a
a
a
a
a
a
a
a
a
a
a
a
a
a
a
a
a
a
a
J
J
J
J
a
J
J
a
a
J
J
a
J
J
J
J
J
J
a
a
a
a
a
a
a
a
a
a
a
a
a
a
w
"}
(81,1,1) = {"
w
a
a
a
a
a
a
a
a
a
a
a
a
a
a
J
J
J
J
J
J
J
J
J
a
J
J
J
J
J
J
J
J
J
J
J
J
J
a
a
a
a
a
a
a
a
a
a
a
a
a
a
a
a
a
a
a
a
a
a
a
a
a
a
a
a
a
a
J
J
J
J
J
a
J
J
a
J
J
J
J
J
a
a
a
a
a
a
a
a
a
a
a
a
a
a
a
a
a
w
"}
(82,1,1) = {"
w
a
a
a
a
a
a
a
a
a
a
a
a
a
a
J
J
a
J
J
J
J
a
a
a
a
J
J
J
J
J
J
J
J
J
J
a
a
a
a
a
a
a
a
a
a
a
a
a
a
a
a
a
a
a
a
a
a
a
a
a
a
a
a
a
a
a
a
a
J
J
a
J
J
J
J
J
J
J
a
a
a
a
a
a
a
a
a
a
a
a
a
a
a
a
a
a
a
a
w
"}
(83,1,1) = {"
w
a
a
a
a
a
a
a
a
a
a
a
a
a
a
J
a
J
J
a
J
a
a
a
a
a
a
a
J
a
a
J
J
a
a
a
a
a
a
a
a
a
a
a
a
a
a
a
a
a
a
a
a
a
a
a
a
a
a
a
a
a
a
a
a
a
a
a
a
a
J
a
J
a
J
J
a
a
a
a
a
a
a
a
a
a
a
a
a
a
a
a
a
a
a
a
a
a
a
w
"}
(84,1,1) = {"
w
a
a
a
a
a
a
a
a
a
a
a
a
a
a
a
J
a
J
J
a
a
a
a
a
a
a
a
a
a
J
a
a
J
a
a
J
a
a
a
a
a
a
a
a
a
a
a
a
a
a
a
a
a
a
a
a
a
a
a
a
a
a
a
a
a
a
a
a
a
a
a
a
a
a
a
a
a
a
a
a
a
a
a
a
a
a
a
a
a
a
a
a
a
a
a
a
a
a
w
"}
(85,1,1) = {"
w
a
a
a
a
a
a
a
a
a
a
a
a
a
a
a
a
a
a
J
a
a
a
a
a
a
a
a
a
a
a
a
a
a
a
a
a
a
a
a
a
a
a
a
a
a
a
a
a
a
a
a
a
a
a
a
a
a
a
a
a
a
a
a
a
a
a
a
a
a
a
a
a
a
a
a
a
a
a
a
a
a
a
a
a
a
a
a
a
a
a
a
a
a
a
a
a
a
a
w
"}
(86,1,1) = {"
w
a
a
a
a
a
a
a
a
a
a
a
a
a
J
a
a
a
a
a
a
a
a
a
a
a
a
a
a
a
a
a
a
a
a
a
a
a
a
a
a
a
a
a
a
a
a
a
a
a
a
a
a
a
a
a
a
a
a
a
a
a
a
a
a
a
a
a
a
a
a
a
a
a
a
a
a
a
a
a
a
a
a
a
a
a
a
a
a
a
a
a
a
a
a
a
a
a
a
w
"}
(87,1,1) = {"
w
a
a
a
a
a
a
a
a
a
a
a
a
a
a
a
a
a
a
a
a
a
a
a
a
a
a
a
a
a
a
a
a
a
a
a
a
a
a
a
a
a
a
a
a
a
a
a
a
a
a
a
a
a
a
a
a
a
a
a
a
a
a
a
a
a
a
a
a
a
a
a
a
a
a
a
a
a
a
a
a
a
a
a
a
a
a
a
a
a
a
a
a
a
a
a
a
a
a
w
"}
(88,1,1) = {"
w
a
a
a
a
a
a
a
a
a
a
a
a
a
a
q
a
a
a
a
a
a
a
a
a
a
a
a
a
a
a
a
a
a
a
a
a
a
a
a
a
a
a
a
a
a
a
a
a
a
a
a
a
a
a
a
a
a
a
a
a
a
a
a
a
a
a
a
a
a
a
a
a
a
a
a
a
a
a
a
a
a
a
a
a
a
a
a
a
a
a
a
a
a
a
a
a
a
a
w
"}
(89,1,1) = {"
w
a
a
a
a
a
a
a
a
a
a
a
a
a
a
a
J
a
a
a
a
a
a
a
a
a
a
a
a
a
a
a
a
a
a
a
a
a
a
a
a
a
a
a
a
a
a
a
a
a
a
a
a
a
a
a
a
a
a
a
a
a
a
a
a
a
a
a
a
a
a
a
a
a
a
a
a
a
a
a
a
a
a
a
a
a
a
a
a
a
a
a
a
a
a
a
a
a
a
w
"}
(90,1,1) = {"
w
a
a
a
a
a
a
a
a
a
a
a
a
a
a
a
a
a
a
a
a
a
a
a
a
a
a
a
a
a
a
a
a
a
a
a
a
a
a
a
a
a
a
a
a
a
a
a
a
a
a
a
a
a
a
a
a
a
a
a
a
a
a
a
a
a
a
a
a
a
a
a
a
a
a
a
a
a
a
a
a
a
a
a
a
a
a
a
a
a
a
a
a
a
a
a
a
a
a
w
"}
(91,1,1) = {"
w
a
a
a
a
a
a
a
a
a
a
a
a
a
a
a
a
a
a
a
a
a
a
a
a
a
a
a
a
a
a
a
a
a
a
a
a
a
a
a
a
a
a
a
a
a
a
a
a
a
a
a
a
a
a
a
a
a
a
a
a
a
a
a
a
a
a
a
a
a
a
a
a
a
a
a
a
a
q
a
a
a
a
a
a
a
a
a
a
a
a
a
a
a
a
a
a
a
a
w
"}
(92,1,1) = {"
w
a
a
a
a
a
a
a
a
a
a
a
a
a
a
a
a
a
J
a
a
a
a
a
a
a
a
a
a
a
a
a
a
a
a
a
a
a
a
a
a
a
a
a
a
a
a
a
a
a
a
a
a
a
a
a
a
a
a
a
a
a
a
a
a
a
a
a
a
a
a
a
a
a
a
a
a
a
a
a
a
a
a
a
a
a
a
a
a
a
a
a
a
a
a
a
a
a
a
w
"}
(93,1,1) = {"
w
a
a
a
a
a
a
a
a
a
a
a
a
a
a
a
a
a
a
a
a
a
a
a
a
a
a
a
a
a
a
a
a
a
a
a
a
a
a
a
a
a
a
a
a
a
a
a
a
a
a
a
a
a
a
a
a
a
a
a
a
a
a
a
a
a
a
a
a
a
a
a
a
a
a
a
a
a
a
a
a
a
a
a
a
a
a
a
a
a
a
a
a
a
a
a
a
a
a
w
"}
(94,1,1) = {"
w
a
a
a
a
a
a
a
a
a
a
a
a
a
a
a
a
a
a
a
a
a
a
a
a
a
a
a
a
a
a
a
a
a
a
a
a
a
a
a
a
a
a
a
a
a
a
a
a
a
a
a
a
a
a
a
a
a
a
a
a
a
a
a
a
a
a
a
a
a
a
a
a
a
a
a
a
a
a
a
a
a
a
a
a
a
a
a
a
a
a
a
a
a
a
a
a
a
a
w
"}
(95,1,1) = {"
w
a
a
a
a
a
a
a
a
a
a
a
a
a
a
a
a
a
a
a
a
a
a
a
a
a
a
a
a
a
a
a
a
a
a
a
a
a
a
a
a
a
a
a
a
a
a
a
a
a
a
a
a
a
a
a
a
a
a
a
a
a
a
a
a
a
a
a
a
a
a
a
a
a
a
a
a
a
a
a
a
a
a
a
a
a
a
a
a
a
a
a
a
a
a
a
a
a
a
w
"}
(96,1,1) = {"
w
a
a
a
a
a
a
a
a
a
a
a
a
a
a
a
a
a
a
a
a
a
a
a
a
a
a
a
a
a
a
a
a
a
a
a
a
a
a
a
a
a
a
a
a
a
a
a
a
a
a
a
a
a
a
a
a
a
a
a
a
a
a
a
a
a
a
a
a
a
a
a
a
a
a
a
a
a
a
a
a
a
a
a
a
a
a
a
a
a
a
a
a
a
a
a
a
a
a
w
"}
(97,1,1) = {"
w
a
a
a
a
a
a
a
a
a
a
a
a
a
a
a
a
a
a
a
a
a
a
a
a
a
a
a
a
a
a
a
a
a
a
a
a
a
a
a
a
a
a
a
a
a
a
a
a
a
a
a
a
a
a
a
a
a
a
a
a
a
a
a
a
a
a
a
a
a
a
a
a
a
a
a
a
a
a
a
a
a
a
a
a
a
a
a
a
a
a
a
a
a
a
a
a
a
a
w
"}
(98,1,1) = {"
w
a
a
a
a
a
a
a
a
a
a
a
a
a
a
a
a
a
a
a
a
a
a
a
a
a
a
a
a
a
a
a
a
a
a
a
a
a
a
a
a
a
a
a
a
a
a
a
a
a
a
a
a
a
a
a
a
a
a
a
a
a
a
a
a
a
a
a
a
a
a
a
a
a
a
a
a
a
a
a
a
a
a
a
a
a
a
a
a
a
a
a
a
a
a
a
a
a
a
w
"}
(99,1,1) = {"
w
a
a
a
a
a
a
a
a
a
a
a
a
a
a
a
a
a
a
a
a
a
a
a
a
a
a
a
a
a
a
a
a
a
a
a
a
a
a
a
a
a
a
a
a
a
a
a
a
a
a
a
a
a
a
a
a
a
a
a
a
a
a
a
a
a
a
a
a
a
a
a
a
a
a
a
a
a
a
a
a
a
a
a
a
a
a
a
a
a
a
a
a
a
a
a
a
a
a
w
"}
(100,1,1) = {"
w
w
w
w
w
w
w
w
w
w
w
w
w
w
w
w
w
w
w
w
w
w
w
w
w
w
w
w
w
w
w
w
w
w
w
w
w
w
w
w
w
w
w
w
w
w
w
w
w
w
w
w
w
w
w
w
w
w
w
w
w
w
w
w
w
w
w
w
w
w
w
w
w
w
w
w
w
w
w
w
w
w
w
w
w
w
w
w
w
w
w
w
w
w
w
w
w
w
w
w
"}
